Job ID,Agency,# Of Positions,Civil Service Title,Salary Range From,Salary Range To,Salary Frequency,Salary Range
180149,DEPT OF ENVIRONMENT PROTECTION,1,ASSOCIATE PROJECT MANAGER,79457,107720,Annual,28263
181317,DEPT OF ENVIRONMENT PROTECTION,1,GARDENER,38277,55090,Annual,16813
181479,DEPT OF HEALTH/MENTAL HYGIENE,1,PRINCIPAL ADMINISTRATIVE ASSOC,44735,55000,Annual,10265
151937,NYC HOUSING AUTHORITY,4,ASSOCIATE PROJECT MANAGER,62942,92249,Annual,29307
152008,NYC HOUSING AUTHORITY,4,ASSOCIATE PROJECT MANAGER,62942,92249,Annual,29307
181944,DEPT OF ENVIRONMENT PROTECTION,1,COMPUTER SPECIALIST (SOFTWARE),87203,120754,Annual,33551
182266,DEPARTMENT OF TRANSPORTATION,2,CITY PLANNER,57497,84640,Annual,27143
152669,DEPT OF ENVIRONMENT PROTECTION,1,MARINE ELECTRONICS TECHNICIAN,73034,107985,Annual,34951
152673,DEPT OF ENVIRONMENT PROTECTION,1,ADMINISTRATIVE STAFF ANALYST (,54740,146276,Annual,91536
182479,NYC HOUSING AUTHORITY,1,HEATING PLANT TECHNICIAN (HA),27772,45632,Annual,17860
182890,DEPT OF HEALTH/MENTAL HYGIENE,1,ADMINISTRATIVE STAFF ANALYST (,78000,90000,Annual,12000
174736,DEPT OF ENVIRONMENT PROTECTION,1,ASSOCIATE PROJECT MANAGER,65822,96470,Annual,30648
152679,DEPT OF ENVIRONMENT PROTECTION,11,SENIOR STATIONARY ENGINEER (EL,109850,109850,Annual,0
152738,LAW DEPARTMENT,1,CLERICAL ASSOCIATE,30683,49707,Annual,19024
183112,DEPT OF INFO TECH & TELECOMM,1,COMPUTER PROGRAMMER ANALYST,45174,62370,Annual,17196
183500,LAW DEPARTMENT,1,CLERICAL ASSOCIATE,32086,51981,Annual,19895
155260,DEPT OF ENVIRONMENT PROTECTION,1,SCIENTIST (WATER ECOLOGY),55544,79244,Annual,23700
156256,DEPT OF ENVIRONMENT PROTECTION,1,QUALITY ASSURANCE SPECIALIST (,38058,53999,Annual,15941
157511,DEPT OF HEALTH/MENTAL HYGIENE,1,CRIMINALIST ASSISTANT DIRECTOR,60000,80000,Annual,20000
183879,DEPT OF HEALTH/MENTAL HYGIENE,3,CLERICAL ASSOCIATE,26869,30899,Annual,4030
159215,TAXI & LIMOUSINE COMMISSION,2,COMMUNITY ASSOCIATE,32321,53788,Annual,21467
257545,DEPT OF ENVIRONMENT PROTECTION,1,CONSTRUCTION PROJECT MANAGER,61237,88686,Annual,27449
86699,DEPT OF CITYWIDE ADMIN SVCS,2,GRAPHIC ARTIST,38443,60241,Annual,21798
87990,DEPARTMENT OF BUSINESS SERV.,1,CONTRACT REVIEWER (OFFICE OF L,42405,65485,Annual,23080
93086,DEPT OF INFO TECH & TELECOMM,1,COMPUTER SYSTEMS MANAGER,49492,101500,Annual,52008
163776,DEPT OF ENVIRONMENT PROTECTION,1,ASSOCIATE PROJECT MANAGER,75981,103007,Annual,27026
114352,DEPT OF ENVIRONMENT PROTECTION,5,SENIOR STATIONARY ENGINEER (EL,109850,109850,Annual,0
102221,DEPT OF ENVIRONMENT PROTECTION,1,ENVIRONMENTAL ENGINEERING INTE,43349,52496,Annual,9147
117261,DEPT OF ENVIRONMENT PROTECTION,1,CIVIL ENGINEERING INTERN,43349,52496,Annual,9147
168874,DEPT OF ENVIRONMENT PROTECTION,1,COMPUTER PROGRAMMER ANALYST,45174,62370,Annual,17196
124287,LAW DEPARTMENT,1,STUDENT LEGAL SPECIALIST,32850,37778,Annual,4928
206286,DEPARTMENT OF TRANSPORTATION,1,COMPUTER SPECIALIST (SOFTWARE),87203,120754,Annual,33551
124564,DEPT OF ENVIRONMENT PROTECTION,1,CITY RESEARCH SCIENTIST,63662,79899,Annual,16237
124839,DEPT OF ENVIRONMENT PROTECTION,1,PORT MARINE ENGINEER,69417,97893,Annual,28476
128877,DEPT OF ENVIRONMENT PROTECTION,1,CITY PARK WORKER,29271,45465,Annual,16194
170412,DEPT OF ENVIRONMENT PROTECTION,2,CONSTRUCTION PROJECT MANAGER I,45333,54898,Annual,9565
131277,NYC HOUSING AUTHORITY,5,INDUSTRIAL HYGIENIST,47251,63506,Annual,16255
132292,NYC HOUSING AUTHORITY,52,MAINTENANCE WORKER,51908,54580,Annual,2672
171287,DEPT OF ENVIRONMENT PROTECTION,1,COMPUTER PROGRAMMER ANALYST,45174,62370,Annual,17196
138531,DEPT OF ENVIRONMENT PROTECTION,1,ASSOCIATE CHEMIST,50623,75083,Annual,24460
134511,DEPT OF ENVIRONMENT PROTECTION,1,ENVIRONMENTAL ENGINEER,57129,82737,Annual,25608
134515,DEPT OF ENVIRONMENT PROTECTION,1,CIVIL ENGINEER,57129,82737,Annual,25608
137433,DEPT OF HEALTH/MENTAL HYGIENE,1,PROCUREMENT ANALYST,50598,85053,Annual,34455
172053,DEPT OF INFO TECH & TELECOMM,1,ADM MANAGER-NON-MGRL FRM M1/M2,49492,69000,Annual,19508
140566,DEPT OF ENVIRONMENT PROTECTION,1,ASSOCIATE PROJECT MANAGER,57129,82737,Annual,25608
148717,NYC HOUSING AUTHORITY,3,ASBESTOS HAZARD INVESTIGATOR,45876,68840,Annual,22964
149962,DEPT OF HEALTH/MENTAL HYGIENE,1,CERT. IT ADMINISTRATOR WAN,77733,95000,Annual,17267
150410,NYC HOUSING AUTHORITY,1,AGENCY ATTORNEY,69085,69085,Annual,0
151131,NYC HOUSING AUTHORITY,1,ADMINISTRATIVE STAFF ANALYST (,90000,110000,Annual,20000
177048,DEPT OF INFO TECH & TELECOMM,1,COMPUTER SPECIALIST (SOFTWARE),81290,95896,Annual,14606
177866,DEPARTMENT OF FINANCE,1,ASSOCIATE STAFF ANALYST,68466,80000,Annual,11534
177962,NYC HOUSING AUTHORITY,3,SUPERVISOR OF ELEVATOR MAINTEN,54740,146276,Annual,91536
151405,DEPT OF ENVIRONMENT PROTECTION,4,CONSTRUCTION PROJECT MANAGER I,43349,52496,Annual,9147
193881,DEPT OF HEALTH/MENTAL HYGIENE,1,LABORATORY HELPER,29437,29437,Annual,0
151650,NYC HOUSING AUTHORITY,3,PLUMBER'S HELPER,61387,61387,Annual,0
187049,NYC HOUSING AUTHORITY,3,HIGH PRESSURE PLANT TENDER,65459,65459,Annual,0
187199,DEPT OF ENVIRONMENT PROTECTION,1,PORT MARINE ENGINEER,69417,97893,Annual,28476
187344,DEPT OF HEALTH/MENTAL HYGIENE,2,COMPUTER ASSOC (SOFTWARE),58721,67529,Annual,8808
193893,DEPT OF ENVIRONMENT PROTECTION,1,CITY RESEARCH SCIENTIST,66575,83555,Annual,16980
195614,NYC HOUSING AUTHORITY,1,CITY PLANNER,64626,94409,Annual,29783
201367,DEPARTMENT OF TRANSPORTATION,1,ESTIMATOR (GENERAL CONSTRUCTIO,50328,75516,Annual,25188
195805,ADMIN FOR CHILDREN'S SVCS,2,ASSOCIATE STAFF ANALYST,59536,88649,Annual,29113
187714,ADMIN FOR CHILDREN'S SVCS,1,CERTIFIED IT ADMINISTRATOR LAN,72260,98163,Annual,25903
189019,DEPT OF ENVIRONMENT PROTECTION,1,ASSOCIATE PUBLIC HEALTH SANITA,53130,82577,Annual,29447
190197,DEPT OF ENVIRONMENT PROTECTION,1,ASSOCIATE STAFF ANALYST,59536,75568,Annual,16032
195938,NYC HOUSING AUTHORITY,1,ELECTRICAL ENGINEER,71030,98681,Annual,27651
199744,NYC HOUSING AUTHORITY,1,ADMINISTRATIVE PROJECT MANAGER,90000,105000,Annual,15000
190769,ADMIN FOR CHILDREN'S SVCS,1,ADMINISTRATIVE PUBLIC HEALTH N,90000,140000,Annual,50000
196559,DEPARTMENT OF FINANCE,1,COMPUTER SPECIALIST (SOFTWARE),72260,83099,Annual,10839
191317,DEPT OF ENVIRONMENT PROTECTION,1,CIVIL ENGINEER,59743,86523,Annual,26780
254625,HRA/DEPT OF SOCIAL SERVICES,1,COMPUTER SYSTEMS MANAGER,58675,156793,Annual,98118
191546,DEPT OF ENVIRONMENT PROTECTION,1,COMPUTER PROGRAMMER ANALYST,45174,62370,Annual,17196
191646,DEPT OF PARKS & RECREATION,16,FORESTER,50000,52460,Annual,2460
192062,DEPT OF ENVIRONMENT PROTECTION,1,CITY PLANNING TECHNICIAN,34325,52660,Annual,18335
197159,DEPT OF HEALTH/MENTAL HYGIENE,1,SUPERVISOR II SOCIAL WORK,58584,76924,Annual,18340
197316,DEPT OF INFO TECH & TELECOMM,4,ASSOCIATE CALL CENTER REPRESEN,43118,49586,Annual,6468
192236,DEPT OF HEALTH/MENTAL HYGIENE,1,FORENSIC MORTUARY TECHNICIAN,49090,56453,Annual,7363
254630,DEPT OF ENVIRONMENT PROTECTION,1,ADMINISTRATIVE CONSTRUCTION PR,58675,156793,Annual,98118
197535,DEPT OF HEALTH/MENTAL HYGIENE,1,COMPUTER ASSOC (SOFTWARE),67527,98853,Annual,31326
280355,DEPARTMENT OF BUILDINGS,1,COMPUTER SPECIALIST (SOFTWARE),92065,100000,Annual,7935
197767,TAXI & LIMOUSINE COMMISSION,1,AGENCY ATTORNEY,55615,84904,Annual,29289
192723,DEPT OF INFO TECH & TELECOMM,1,RESEARCH ASSISTANT,40055,60611,Annual,20556
192756,DEPARTMENT OF TRANSPORTATION,1,CERTIFIED IT ADMINISTRATOR LAN,81290,114954,Annual,33664
192759,DEPARTMENT OF TRANSPORTATION,1,COMPUTER SPECIALIST (SOFTWARE),81290,105464,Annual,24174
192766,DEPT OF ENVIRONMENT PROTECTION,1,MECHANICAL ENGINEER,59743,86523,Annual,26780
198928,DEPARTMENT OF FINANCE,1,ADMINISTRATIVE STAFF ANALYST (,56937,83000,Annual,26063
193109,DEPT OF INFO TECH & TELECOMM,1,ADM MANAGER-NON-MGRL FRM M1/M2,53373,72000,Annual,18627
199342,DEPARTMENT OF FINANCE,1,COMPUTER SYSTEMS MANAGER,57244,120000,Annual,62756
184882,NYC HOUSING AUTHORITY,1,ADMINISTRATIVE ENGINEER,90000,105000,Annual,15000
185056,LAW DEPARTMENT,3,PARALEGAL AIDE,38089,53300,Annual,15211
199768,DEPT OF INFO TECH & TELECOMM,1,COMMUNITY ASSOCIATE,33799,56249,Annual,22450
185606,DEPARTMENT OF TRANSPORTATION,1,MANAGEMENT AUDITOR,49389,79013,Annual,29624
186016,DEPT OF HEALTH/MENTAL HYGIENE,1,ADMINISTRATIVE STAFF ANALYST (,78000,90000,Annual,12000
186182,DEPT OF HEALTH/MENTAL HYGIENE,2,CRIMINALIST,58136,58136,Annual,0
220128,TAXI & LIMOUSINE COMMISSION,1,COMPUTER SYSTEMS MANAGER,70000,92000,Annual,22000
220356,HOUSING PRESERVATION & DVLPMNT,1,CONSTRUCTION PROJECT MANAGER,51586,77404,Annual,25818
220511,DEPT OF HEALTH/MENTAL HYGIENE,4,CRIMINALIST,59589,59589,Annual,0
225491,DEPT OF ENVIRONMENT PROTECTION,8,COMMUNITY COORDINATOR,48895,75900,Annual,27005
225597,DEPARTMENT OF CORRECTION,26,COOK,36494,46362,Annual,9868
231077,DEPT OF ENVIRONMENT PROTECTION,1,ASSOCIATE PROJECT MANAGER,61237,88686,Annual,27449
221045,NYC EMPLOYEES RETIREMENT SYS,1,CERT. IT ADMINISTRATOR WAN,89383,134914,Annual,45531
221961,DEPARTMENT OF FINANCE,1,PRINCIPAL ADMINISTRATIVE ASSOC,41810,48082,Annual,6272
202767,DEPT OF ENVIRONMENT PROTECTION,1,ASSOCIATE PROJECT MANAGER,65822,96470,Annual,30648
203029,DEPT OF HEALTH/MENTAL HYGIENE,1,NURSE PRACTITIONER(DEPT HEALTH,63710,92000,Annual,28290
205470,DEPT OF ENVIRONMENT PROTECTION,2,ELECTRICAL ENGINEERING INTERN,45333,54898,Annual,9565
204915,DEPT OF ENVIRONMENT PROTECTION,1,ASSISTANT ENVIRONMENTAL ENGINE,50328,75516,Annual,25188
222312,DEPT OF ENVIRONMENT PROTECTION,1,ADMINISTRATIVE ENGINEER,58675,156793,Annual,98118
206424,DEPT OF ENVIRONMENT PROTECTION,5,AIR POLLUTION INSPECTOR,30817,39064,Annual,8247
222840,DEPARTMENT OF TRANSPORTATION,3,ADMINISTRATIVE PROJECT MANAGER,53051,145991,Annual,92940
224253,DEPT OF ENVIRONMENT PROTECTION,1,ADMINISTRATIVE ENGINEER,53051,145991,Annual,92940
278273,TAXI & LIMOUSINE COMMISSION,1,COMPUTER SYSTEMS MANAGER,54643,100000,Annual,45357
209710,DEPT OF HEALTH/MENTAL HYGIENE,9,CONSULTANT (PUBLIC HEALTH-SOCI,58584,67372,Annual,8788
223194,DEPARTMENT OF TRANSPORTATION,1,CITY PLANNER,66242,96769,Annual,30527
210312,DEPT OF INFO TECH & TELECOMM,1,ADM MANAGER-NON-MGRL FRM M1/M2,64000,71000,Annual,7000
211090,ADMIN FOR CHILDREN'S SVCS,8,STAFF NURSE,69252,69252,Annual,0
223244,DEPARTMENT OF FINANCE,1,COMPUTER SYSTEMS MANAGER,80379,150000,Annual,69621
223426,DEPT OF PARKS & RECREATION,3,ARCHITECT,73000,101148,Annual,28148
223736,DEPT OF ENVIRONMENT PROTECTION,1,ASSOCIATE PUBLIC HEALTH SANITA,60673,91795,Annual,31122
223946,DEPT OF HEALTH/MENTAL HYGIENE,100,SPECIAL CONSULTANT (MENTAL HEA,54347,74187,Annual,19840
215639,LAW DEPARTMENT,6,ASSISTANT CORPORATION COUNSEL,72617,138880,Annual,66263
249269,HRA/DEPT OF SOCIAL SERVICES,1,COMPUTER SYSTEMS MANAGER,53051,145991,Annual,92940
224058,DEPT OF HEALTH/MENTAL HYGIENE,1,CITY RESEARCH SCIENTIST,68239,68239,Annual,0
224194,OFFICE OF MANAGEMENT & BUDGET,1,BUDGET ANALYST (OMB)-MANAGERIA,106475,106475,Annual,0
224243,DEPARTMENT OF FINANCE,1,CONFIDENTIAL STRATEGY PLANNER,54128,91112,Annual,36984
218977,DEPARTMENT OF TRANSPORTATION,1,ADMINISTRATIVE ENGINEER,53051,145991,Annual,92940
219112,NYC HOUSING AUTHORITY,1,MAINTENANCE WORKER,51908,54580,Annual,2672
219144,NYC HOUSING AUTHORITY,2,INDUSTRIAL HYGIENIST,50649,68071,Annual,17422
279214,FINANCIAL INFO SVCS AGENCY,1,COMPUTER SYSTEMS MANAGER,100000,120000,Annual,20000
224435,DEPARTMENT OF FINANCE,1,PRINCIPAL ADMINISTRATIVE ASSOC,46782,53799,Annual,7017
219633,DEPT OF HEALTH/MENTAL HYGIENE,8,CRIMINALIST,59589,59589,Annual,0
224514,OFFICE OF THE COMPTROLLER,1,COMPUTER SYSTEMS MANAGER,85000,105000,Annual,20000
224568,DEPT OF HEALTH/MENTAL HYGIENE,1,CRIMINALIST,59589,59589,Annual,0
225247,DEPARTMENT OF TRANSPORTATION,2,CIVIL ENGINEER,61237,88686,Annual,27449
225490,DEPT OF ENVIRONMENT PROTECTION,1,CIVIL ENGINEERING INTERN,46466,56270,Annual,9804
226677,TAXI & LIMOUSINE COMMISSION,1,COMPUTER SYSTEMS MANAGER,53051,92000,Annual,38949
226791,DEPT OF ENVIRONMENT PROTECTION,1,ASSOCIATE STAFF ANALYST,62260,74000,Annual,11740
227127,DEPT OF ENVIRONMENT PROTECTION,2,WATER USE INSPECTOR,41250,57295,Annual,16045
227159,DEPT OF ENVIRONMENT PROTECTION,1,CIVIL ENGINEERING INTERN,46466,56270,Annual,9804
227285,DEPT OF ENVIRONMENT PROTECTION,1,COMPUTER SPECIALIST (SOFTWARE),89383,123773,Annual,34390
247320,DEPT OF ENVIRONMENT PROTECTION,2,MECHANICAL ENGINEERING INTERN,52000,52000,Annual,0
229283,HRA/DEPT OF SOCIAL SERVICES,1,COMPUTER SPECIALIST (SOFTWARE),74066,85176,Annual,11110
249063,DEPARTMENT OF SANITATION,1,CERT IT DEVELOPER (APP),89383,134914,Annual,45531
232886,DEPT OF INFO TECH & TELECOMM,3,BUSINESS PROMOTION COORDINATOR,62671,80000,Annual,17329
232984,DEPT OF ENVIRONMENT PROTECTION,1,COMPUTER SPECIALIST (SOFTWARE),77157,99406,Annual,22249
233005,DEPT OF INFO TECH & TELECOMM,1,COMPUTER SPECIALIST (OPERATION,69253,108000,Annual,38747
227351,TAXI & LIMOUSINE COMMISSION,1,COMMUNITY ASSOCIATE,40000,57655,Annual,17655
229837,DEPT OF INFO TECH & TELECOMM,1,COMPUTER SYSTEMS MANAGER,58675,125000,Annual,66325
233011,DEPARTMENT OF FINANCE,1,ADMINISTRATIVE STAFF ANALYST (,58675,90000,Annual,31325
233017,ADMIN FOR CHILDREN'S SVCS,1,ADMINISTRATIVE DIRECTOR OF SOC,65107,173663,Annual,108556
229916,DEPT OF ENVIRONMENT PROTECTION,1,ELECTRICAL ENGINEER,81443,110413,Annual,28970
230147,DEPT OF HEALTH/MENTAL HYGIENE,1,PRINCIPAL ADMINISTRATIVE ASSOC,41810,61248,Annual,19438
230250,DEPT OF ENVIRONMENT PROTECTION,4,ENGINEERING TECHNICIAN,50674,70623,Annual,19949
230490,LAW DEPARTMENT,1,COMPUTER ASSOC (OPERATIONS),55556,82776,Annual,27220
230388,HOUSING PRESERVATION & DVLPMNT,1,COMMUNITY COORDINATOR,48895,60000,Annual,11105
227523,DEPARTMENT OF TRANSPORTATION,1,ASSOCIATE STAFF ANALYST,62260,92704,Annual,30444
230974,ADMIN FOR CHILDREN'S SVCS,7,CHILD AND FAMILY SPECIALIST,66000,89008,Annual,23008
231144,DEPARTMENT OF INVESTIGATION,1,DEPUTY INSPECTOR GENERAL,75000,120000,Annual,45000
227629,DEPT OF PARKS & RECREATION,1,ELECTRICAL ENGINEER,65000,88000,Annual,23000
227739,DEPARTMENT OF TRANSPORTATION,1,HIGHWAY TRANSPORTATION SPECIAL,61237,88686,Annual,27449
231293,DEPARTMENT OF TRANSPORTATION,5,MARINE OILER(FERRY OPERATIONS),48211,55443,Annual,7232
231349,DEPT OF PARKS & RECREATION,1,ASSISTANT ARCHITECT,70000,77000,Annual,7000
228094,NYC EMPLOYEES RETIREMENT SYS,1,COMPUTER SPECIALIST (SOFTWARE),77157,99406,Annual,22249
228364,DEPT OF HEALTH/MENTAL HYGIENE,1,CLERICAL ASSOCIATE,29690,34143,Annual,4453
228447,DEPT OF INFO TECH & TELECOMM,1,ADMINISTRATIVE BUSINESS PROMOT,53051,110000,Annual,56949
231350,DEPT OF HEALTH/MENTAL HYGIENE,4,CRIMINALIST,85716,85716,Annual,0
231376,DEPARTMENT OF FINANCE,1,COMPUTER SYSTEMS MANAGER,58675,130000,Annual,71325
228487,DEPARTMENT OF FINANCE,1,ADMINISTRATIVE STAFF ANALYST (,73144,120000,Annual,46856
228525,DEPT OF HEALTH/MENTAL HYGIENE,1,CRIMINALIST,49796,49796,Annual,0
231851,HOUSING PRESERVATION & DVLPMNT,1,CITY PLANNER,49897,72061,Annual,22164
228550,ADMIN FOR CHILDREN'S SVCS,6,ADMINISTRATIVE DIRECTOR OF SOC,58675,95000,Annual,36325
228597,ADMIN FOR CHILDREN'S SVCS,1,ADMINISTRATIVE DIRECTOR OF SOC,53051,90000,Annual,36949
228749,DEPARTMENT OF TRANSPORTATION,1,COMPUTER SPECIALIST (SOFTWARE),89383,123773,Annual,34390
231945,ADMIN FOR CHILDREN'S SVCS,9,COMMUNITY COORDINATOR,48895,75900,Annual,27005
231965,DEPARTMENT OF TRANSPORTATION,15,BRIDGE OPERATOR,36991,51424,Annual,14433
228904,DEPT OF ENVIRONMENT PROTECTION,1,ELECTRICAL ENGINEER,81443,110413,Annual,28970
232338,DEPT OF INFO TECH & TELECOMM,1,CERTIFIED IT ADMINISTRATOR (LA,87203,120000,Annual,32797
232360,DEPT OF INFO TECH & TELECOMM,2,COMPUTER SPECIALIST (OPERATION,69253,108101,Annual,38848
228947,DEPARTMENT OF TRANSPORTATION,1,MANAGEMENT AUDITOR,58617,88661,Annual,30044
243982,POLICE DEPARTMENT,1,COMMUNITY ASSISTANT,29391,38131,Annual,8740
225848,DEPT OF HEALTH/MENTAL HYGIENE,4,COMMUNITY SERVICE AIDE,26536,30516,Annual,3980
226044,DEPT OF INFO TECH & TELECOMM,1,CLERICAL ASSOCIATE,32888,50000,Annual,17112
226045,DEPT OF INFO TECH & TELECOMM,1,ASSOCIATE STAFF ANALYST,62260,92704,Annual,30444
232421,DEPT OF INFO TECH & TELECOMM,2,COMPUTER SPECIALIST (OPERATION,69253,108101,Annual,38848
232635,DEPT OF HEALTH/MENTAL HYGIENE,1,COMPUTER ASSOC (SOFTWARE),60189,69217,Annual,9028
232773,HOUSING PRESERVATION & DVLPMNT,4,COMPUTER ASSOC (OPERATIONS),76245,90000,Annual,13755
226646,DEPARTMENT OF TRANSPORTATION,1,ACCOUNTANT,45385,61669,Annual,16284
236930,DEPARTMENT OF TRANSPORTATION,1,CERTIFIED IT ADMINISTRATOR (LA,87203,131623,Annual,44420
233378,DEPARTMENT OF TRANSPORTATION,1,ADMINISTRATIVE PROJECT MANAGER,48535,134433,Annual,85898
237006,DEPT OF ENVIRONMENT PROTECTION,3,COMPUTER SPECIALIST (SOFTWARE),74066,92308,Annual,18242
239094,DEPARTMENT OF FINANCE,1,CERTIFIED IT ADMINISTRATOR (LA,81290,100000,Annual,18710
239188,DEPT OF ENVIRONMENT PROTECTION,4,WATERSHED MAINTAINER,37085,54243,Annual,17158
237029,DEPT OF ENVIRONMENT PROTECTION,3,CIVIL ENGINEER,72805,101148,Annual,28343
239204,ADMIN FOR CHILDREN'S SVCS,1,CITY RESEARCH SCIENTIST,68239,85644,Annual,17405
239208,HOUSING PRESERVATION & DVLPMNT,8,INSPECTOR (HOUSING),48410,70715,Annual,22305
239234,DEPT OF ENVIRONMENT PROTECTION,1,GEOLOGIST,51586,77404,Annual,25818
237059,DEPT OF ENVIRONMENT PROTECTION,1,COMMUNITY COORDINATOR,48895,67000,Annual,18105
237245,ADMIN FOR CHILDREN'S SVCS,20,SUPERVISOR I SOCIAL WORK,51376,74187,Annual,22811
234202,DEPT OF HEALTH/MENTAL HYGIENE,1,EVIDENCE AND PROPERTY CONTROL,52065,52065,Annual,0
234203,ADMIN FOR CHILDREN'S SVCS,1,ASSOCIATE STAFF ANALYST,63817,95022,Annual,31205
237569,DEPT OF HEALTH/MENTAL HYGIENE,1,CITY RESEARCH SCIENTIST,57969,63765,Annual,5796
234206,DEPT OF HEALTH/MENTAL HYGIENE,1,LABORATORY HELPER,33590,33590,Annual,0
234365,DEPT OF INFO TECH & TELECOMM,1,COMPUTER SYSTEMS MANAGER,53051,120000,Annual,66949
237576,ADMIN FOR CHILDREN'S SVCS,1,ADMINISTRATIVE STAFF ANALYST (,58675,156793,Annual,98118
243231,HRA/DEPT OF SOCIAL SERVICES,1,STAFF NURSE,69252,69252,Annual,0
237577,ADMIN FOR CHILDREN'S SVCS,1,ASSOCIATE STAFF ANALYST,63817,95022,Annual,31205
237679,NYC HOUSING AUTHORITY,1,ASBESTOS HAZARD INVESTIGATOR,49174,73789,Annual,24615
234921,NYC EMPLOYEES RETIREMENT SYS,1,CERTIFIED IT ADMINISTRATOR (LA,72260,98163,Annual,25903
237827,ADMIN FOR CHILDREN'S SVCS,3,CHILD WELFARE SPECIALIST SUPER,73320,91139,Annual,17819
237981,DEPARTMENT OF FINANCE,1,COMPUTER SPECIALIST (OPERATION,69253,80000,Annual,10747
237866,DEPT OF HEALTH/MENTAL HYGIENE,1,CLERICAL ASSOCIATE,29690,34143,Annual,4453
235183,DEPARTMENT OF TRANSPORTATION,1,PRINCIPAL ADMINISTRATIVE ASSOC,46782,68003,Annual,21221
237878,BOARD OF CORRECTION,1,COMPUTER ASSOC (OPERATIONS),46303,52000,Annual,5697
236270,HOUSING PRESERVATION & DVLPMNT,1,ADMINISTRATIVE PROJECT MANAGER,48535,100000,Annual,51465
237921,ADMIN FOR CHILDREN'S SVCS,1,SUPERVISOR II SOCIAL WORK,60049,82455,Annual,22406
237926,ADMIN FOR CHILDREN'S SVCS,1,ADMINISTRATIVE DIRECTOR OF SOC,53051,145991,Annual,92940
235793,LAW DEPARTMENT,1,STUDENT LEGAL SPECIALIST,35213,40495,Annual,5282
238005,DEPARTMENT OF FINANCE,3,ASSOCIATE INVESTIGATOR (NOT PR,54347,62499,Annual,8152
238162,HOUSING PRESERVATION & DVLPMNT,1,COMPUTER SPECIALIST (OPERATION,85000,95000,Annual,10000
236070,HOUSING PRESERVATION & DVLPMNT,5,SUPERVISOR OF MECHANICAL INSTA,61237,88686,Annual,27449
236071,DEPT OF DESIGN & CONSTRUCTION,3,CIVIL ENGINEER,83887,113725,Annual,29838
236079,DEPARTMENT OF FINANCE,1,ADMINISTRATIVE PROCUREMENT ANA,58675,105000,Annual,46325
238176,DEPT OF ENVIRONMENT PROTECTION,2,CITY PLANNER,49897,72061,Annual,22164
238267,DEPT OF YOUTH & COMM DEV SRVS,2,CONTRACT SPECIALIST,46212,71368,Annual,25156
238466,DEPARTMENT OF FINANCE,1,ADMINISTRATIVE STAFF ANALYST (,58675,80000,Annual,21325
236389,HOUSING PRESERVATION & DVLPMNT,1,COMMUNITY COORDINATOR,65000,75000,Annual,10000
238520,BOARD OF CORRECTION,4,CORRECTIONAL STANDARDS REVIEW,55403,63714,Annual,8311
238629,DEPARTMENT OF TRANSPORTATION,1,CONSTRUCTION PROJECT MANAGER,51586,77404,Annual,25818
238660,OFFICE OF THE COMPTROLLER,1,BUSINESS PROMOTION COORDINATOR,45000,65000,Annual,20000
238845,HOUSING PRESERVATION & DVLPMNT,1,COMMUNITY COORDINATOR,48895,71500,Annual,22605
236740,DEPARTMENT OF FINANCE,1,ADMINISTRATIVE TAX AUDITOR,65107,130000,Annual,64893
238976,DEPT OF ENVIRONMENT PROTECTION,1,CIVIL ENGINEER,72805,101148,Annual,28343
239048,ADMIN FOR CHILDREN'S SVCS,1,PROGRAM EVALUATOR (ACS),60049,89008,Annual,28959
236785,DEPARTMENT OF FINANCE,1,ARCHITECT,61237,88686,Annual,27449
239052,ADMIN FOR CHILDREN'S SVCS,1,COMMUNITY COORDINATOR,48895,75900,Annual,27005
236863,DEPT OF ENVIRONMENT PROTECTION,1,ELECTRICAL ENGINEER,72805,101148,Annual,28343
236864,DEPT OF ENVIRONMENT PROTECTION,2,MECHANICAL ENGINEERING INTERN,52000,52000,Annual,0
239551,ADMIN FOR CHILDREN'S SVCS,1,COMPUTER ASSOC (TECH SUPP),46405,67568,Annual,21163
239558,ADMIN FOR CHILDREN'S SVCS,1,SUPERVISOR OF NURSES,76597,76597,Annual,0
239570,DEPT OF ENVIRONMENT PROTECTION,1,WATERSHED MAINTAINER,37085,54243,Annual,17158
239583,DEPT OF INFO TECH & TELECOMM,1,IT PROJECT SPECIALIST,75000,95000,Annual,20000
241065,DEPT OF HEALTH/MENTAL HYGIENE,1,CLERICAL ASSOCIATE,36166,56775,Annual,20609
242541,OFFICE OF THE COMPTROLLER,1,ASSISTANT BUDGET ANALYST (COMP,39000,48000,Annual,9000
242604,POLICE DEPARTMENT,3,INVESTIGATOR,37492,59863,Annual,22371
242620,LAW DEPARTMENT,3,ASSISTANT CORPORATION COUNSEL,66499,85752,Annual,19253
242630,POLICE DEPARTMENT,1,STAFF ANALYST,48620,66195,Annual,17575
241227,ADMIN FOR CHILDREN'S SVCS,1,ADMINISTRATIVE DIRECTOR OF SOC,65107,173663,Annual,108556
239835,ADMIN FOR CHILDREN'S SVCS,1,CITY MEDICAL DIRECTOR,120000,160000,Annual,40000
241375,ADMIN FOR CHILDREN'S SVCS,1,ADMINISTRATIVE DIRECTOR OF SOC,58675,156793,Annual,98118
239712,DEPT OF ENVIRONMENT PROTECTION,1,CIVIL ENGINEER,72805,101148,Annual,28343
241390,DEPARTMENT OF TRANSPORTATION,2,COMPUTER SPECIALIST (SOFTWARE),77157,99406,Annual,22249
239915,DEPT. OF HOMELESS SERVICES,1,ADMINISTRATIVE COMMUNITY RELAT,53051,145991,Annual,92940
239926,HOUSING PRESERVATION & DVLPMNT,1,ADMINISTRATIVE CITY PLANNER,53051,100000,Annual,46949
241439,DEPT OF YOUTH & COMM DEV SRVS,1,ASSOCIATE CONTRACT SPECIALIST,54401,81976,Annual,27575
244296,DEPT OF INFO TECH & TELECOMM,2,COMPUTER SPECIALIST (SOFTWARE),89383,119000,Annual,29617
240138,DEPT OF INFO TECH & TELECOMM,1,IT PROJECT SPECIALIST,75000,80000,Annual,5000
239965,DEPARTMENT OF INVESTIGATION,1,PROCUREMENT ANALYST,44945,64580,Annual,19635
268098,DEPT OF DESIGN & CONSTRUCTION,3,CONSTRUCTION PROJECT MANAGER,67083,113725,Annual,46642
242175,ADMIN FOR CHILDREN'S SVCS,1,ADMINISTRATIVE STAFF ANALYST (,61031,95022,Annual,33991
241671,DEPT OF HEALTH/MENTAL HYGIENE,1,COMPUTER SPECIALIST (SOFTWARE),83323,108101,Annual,24778
240158,DEPARTMENT OF TRANSPORTATION,1,CLERICAL ASSOCIATE,36166,56775,Annual,20609
242911,DEPT OF ENVIRONMENT PROTECTION,1,CIVIL ENGINEERING INTERN,46466,56270,Annual,9804
241921,DEPT OF HEALTH/MENTAL HYGIENE,1,PROCUREMENT ANALYST,44945,72628,Annual,27683
240416,DEPARTMENT OF TRANSPORTATION,15,DECKHAND,46412,53374,Annual,6962
242010,DEPARTMENT OF CITY PLANNING,1,ASSOCIATE STAFF ANALYST,63817,75000,Annual,11183
241994,ADMIN FOR CHILDREN'S SVCS,1,SUPERVISOR OF NURSES,76597,76597,Annual,0
240779,HRA/DEPT OF SOCIAL SERVICES,10,SOCIAL WORKER,46163,65635,Annual,19472
242043,HRA/DEPT OF SOCIAL SERVICES,1,COMPUTER SPECIALIST (SOFTWARE),83323,108101,Annual,24778
240924,DEPT OF ENVIRONMENT PROTECTION,1,ADMINISTRATIVE ENGINEER,110000,110000,Annual,0
240929,TAXI & LIMOUSINE COMMISSION,1,COMPUTER SYSTEMS MANAGER,74066,92308,Annual,18242
242096,DEPARTMENT OF FINANCE,1,CITY RESEARCH SCIENTIST,68239,80000,Annual,11761
242102,DEPT OF ENVIRONMENT PROTECTION,2,STATIONARY ENGINEER (ELECTRIC),94983,94983,Annual,0
240949,LAW DEPARTMENT,3,COMPUTER ASSOC (OPERATIONS),46303,67469,Annual,21166
242912,DEPT OF ENVIRONMENT PROTECTION,1,CIVIL ENGINEERING INTERN,46466,56270,Annual,9804
242109,DEPT OF INFO TECH & TELECOMM,1,CERTIFIED IT ADMINISTRATOR (LA,87203,125000,Annual,37797
241003,ADMIN FOR CHILDREN'S SVCS,1,COMPUTER ASSOC (SOFTWARE),60189,83440,Annual,23251
242174,ADMIN FOR CHILDREN'S SVCS,2,AGENCY ATTORNEY,57005,87027,Annual,30022
239266,LAW DEPARTMENT,1,COMMUNITY COORDINATOR,48895,75900,Annual,27005
239310,DEPT OF PARKS & RECREATION,1,SURVEYOR,80000,90000,Annual,10000
239312,HOUSING PRESERVATION & DVLPMNT,1,CITY PLANNER,50000,65000,Annual,15000
242469,HRA/DEPT OF SOCIAL SERVICES,1,COMPUTER SYSTEMS MANAGER,70213,115000,Annual,44787
239318,DEPT OF ENVIRONMENT PROTECTION,1,PRINCIPAL ADMINISTRATIVE ASSOC,42856,62779,Annual,19923
242941,DEPT OF INFO TECH & TELECOMM,1,COMPUTER SPECIALIST (SOFTWARE),89383,115000,Annual,25617
239471,ADMIN FOR CHILDREN'S SVCS,1,ADMINISTRATIVE PUBLIC HEALTH N,53051,145991,Annual,92940
239505,DEPT OF ENVIRONMENT PROTECTION,1,CIVIL ENGINEER,72805,101148,Annual,28343
242511,DEPT OF ENVIRONMENT PROTECTION,1,CLERICAL ASSOCIATE,26647,43170,Annual,16523
239541,DEPT OF ENVIRONMENT PROTECTION,1,WATERSHED MAINTAINER,37085,54243,Annual,17158
242646,DEPARTMENT OF INVESTIGATION,1,SPECIAL INVESTIGATOR,40000,69027,Annual,29027
242846,DEPARTMENT OF FINANCE,1,PRINCIPAL ADMINISTRATIVE ASSOC,47951,62000,Annual,14049
243433,DEPARTMENT OF TRANSPORTATION,5,CONSTRUCTION PROJECT MANAGER I,46466,56270,Annual,9804
243558,DEPARTMENT OF FINANCE,1,EXECUTIVE AGENCY COUNSEL,65107,125000,Annual,59893
243565,DEPARTMENT OF TRANSPORTATION,1,INVESTIGATOR,37492,59863,Annual,22371
246314,OFF OF PAYROLL ADMINISTRATION,1,STAFF ANALYST,56458,70546,Annual,14088
243586,DEPARTMENT OF TRANSPORTATION,1,ADM ENGINEER (NON MGRL),48535,132061,Annual,83526
243099,FIRE DEPARTMENT,1,COMPUTER SYSTEMS MANAGER,58675,130000,Annual,71325
246598,DEPARTMENT OF FINANCE,2,COMPUTER SPECIALIST (SOFTWARE),83323,108000,Annual,24677
243613,DEPT OF ENVIRONMENT PROTECTION,1,ADMINISTRATIVE PROJECT MANAGER,85000,100000,Annual,15000
242851,DEPT OF INFO TECH & TELECOMM,3,COMPUTER SPECIALIST (SOFTWARE),89383,115000,Annual,25617
242877,LAW DEPARTMENT,3,CLAIM SPECIALIST,37492,59863,Annual,22371
243638,DEPT OF ENVIRONMENT PROTECTION,1,MECHANICAL ENGINEERING INTERN,52000,52000,Annual,0
243640,ADMIN FOR CHILDREN'S SVCS,2,ADMINISTRATIVE DIRECTOR OF RES,53051,145991,Annual,92940
242878,DEPT OF PARKS & RECREATION,5,COMMUNITY COORDINATOR,50000,60000,Annual,10000
242881,DEPT OF HEALTH/MENTAL HYGIENE,10,CRIMINALIST,49796,49796,Annual,0
243657,DEPARTMENT OF TRANSPORTATION,5,CIVIL ENGINEER,61237,88686,Annual,27449
243658,DEPT OF ENVIRONMENT PROTECTION,1,MACHINIST,70199,81703,Annual,11504
242914,LAW DEPARTMENT,1,STUDENT LEGAL SPECIALIST,35213,40495,Annual,5282
242937,DEPT OF INFO TECH & TELECOMM,1,COMPUTER SPECIALIST (SOFTWARE),83323,105000,Annual,21677
243692,ADMIN FOR CHILDREN'S SVCS,1,STAFF NURSE,69252,69252,Annual,0
242939,DEPT OF INFO TECH & TELECOMM,1,COMPUTER SPECIALIST (SOFTWARE),89383,115000,Annual,25617
243745,DEPARTMENT OF TRANSPORTATION,5,ASSISTANT CIVIL ENGINEER,51586,77404,Annual,25818
243772,DEPT OF ENVIRONMENT PROTECTION,1,ASSOCIATE PROJECT MANAGER,67467,98882,Annual,31415
242977,FIRE DEPARTMENT,1,SENIOR IT ARCHITECT,100000,125000,Annual,25000
243816,ADMIN FOR CHILDREN'S SVCS,1,COMPUTER SPECIALIST (SOFTWARE),74066,92308,Annual,18242
243191,DEPARTMENT OF FINANCE,1,COMPUTER SYSTEMS MANAGER,58675,130000,Annual,71325
243169,DEPARTMENT OF FINANCE,1,ADMINISTRATIVE ARCHITECT,53051,95000,Annual,41949
243886,DEPARTMENT OF FINANCE,1,PRINCIPAL ADMINISTRATIVE ASSOC,42856,49284,Annual,6428
243192,DEPARTMENT OF FINANCE,2,COMPUTER SYSTEMS MANAGER,53051,125000,Annual,71949
243978,FIRE DEPARTMENT,1,COMPUTER SPECIALIST (SOFTWARE),83323,108101,Annual,24778
243993,DEPT OF ENVIRONMENT PROTECTION,1,ADMINISTRATIVE PROJECT MANAGER,48535,134433,Annual,85898
243200,DEPARTMENT OF TRANSPORTATION,1,PRINCIPAL ADMINISTRATIVE ASSOC,42856,62779,Annual,19923
244018,FIRE DEPARTMENT,2,COMPUTER SPECIALIST (SOFTWARE),77157,99406,Annual,22249
243211,DEPT OF DESIGN & CONSTRUCTION,6,ASSOCIATE PROJECT MANAGER,67467,98882,Annual,31415
243238,DEPT OF HEALTH/MENTAL HYGIENE,2,CRIMINALIST,59589,59589,Annual,0
244028,FIRE DEPARTMENT,1,COMPUTER ASSOC (SOFTWARE),69215,101324,Annual,32109
243304,DEPARTMENT OF TRANSPORTATION,1,ADMINISTRATIVE TRANSPORTATION,100000,120000,Annual,20000
244031,FIRE DEPARTMENT,1,COMPUTER SPECIALIST (SOFTWARE),77157,99406,Annual,22249
243343,DEPT OF HEALTH/MENTAL HYGIENE,18,CRIMINALIST,59589,59589,Annual,0
244136,DEPT OF ENVIRONMENT PROTECTION,1,ASSOCIATE QUALITY ASSURANCE SP,53997,75307,Annual,21310
243377,DEPT OF HEALTH/MENTAL HYGIENE,1,CLERICAL ASSOCIATE,32888,37821,Annual,4933
243393,DEPT OF ENVIRONMENT PROTECTION,1,MECHANICAL ENGINEER,72805,101148,Annual,28343
244330,DEPT OF INFO TECH & TELECOMM,2,COMPUTER ASSOC (OPERATIONS),66300,88000,Annual,21700
244820,DEPT OF CITYWIDE ADMIN SVCS,1,ARCHITECT,80000,90000,Annual,10000
245324,DEPARTMENT OF TRANSPORTATION,1,STAFF ANALYST,56458,72310,Annual,15852
243419,LAW DEPARTMENT,1,COMPUTER SPECIALIST (SOFTWARE),77157,99406,Annual,22249
246877,DEPARTMENT OF TRANSPORTATION,1,AGENCY ATTORNEY,64394,96499,Annual,32105
249251,POLICE DEPARTMENT,1,COMMUNITY ASSOCIATE,34644,57655,Annual,23011
246883,OFFICE OF THE COMPTROLLER,1,ADMINISTRATIVE PROCUREMENT ANA,57517,65000,Annual,7483
248014,FIRE DEPARTMENT,1,COMPUTER SPECIALIST (SOFTWARE),77157,99406,Annual,22249
248031,LAW DEPARTMENT,1,COMPUTER ASSOC (SOFTWARE),64807,90202,Annual,25395
248047,LAW DEPARTMENT,1,COMPUTER ASSOC (SOFTWARE),60189,83440,Annual,23251
249126,DEPT OF ENVIRONMENT PROTECTION,1,MECHANICAL ENGINEER,72805,101148,Annual,28343
249226,DEPARTMENT OF TRANSPORTATION,15,BRIDGE OPERATOR,33548,45310,Annual,11762
248153,DEPT OF HEALTH/MENTAL HYGIENE,3,MEDICOLEGAL INVESTIGATOR (OCME,78464,91197,Annual,12733
249284,HRA/DEPT OF SOCIAL SERVICES,1,COMPUTER SYSTEMS MANAGER,58675,156793,Annual,98118
246892,DEPT OF ENVIRONMENT PROTECTION,1,STAFF ANALYST,56458,64927,Annual,8469
247140,DEPT OF INFO TECH & TELECOMM,1,SENIOR IT ARCHITECT,100000,130000,Annual,30000
248248,DEPT OF INFO TECH & TELECOMM,1,RADIO AND TELEVISION OPERATOR,43334,50000,Annual,6666
264965,DEPT OF INFO TECH & TELECOMM,2,COMPUTER SPECIALIST (OPERATION,71330,111344,Annual,40014
248320,DEPT OF HEALTH/MENTAL HYGIENE,1,DEPUTY COMMISSIONER (HEALTH),88417,209652,Annual,121235
251154,DEPT OF DESIGN & CONSTRUCTION,4,ADM ENGINEER (NON MGRL),48535,132061,Annual,83526
248442,DEPT OF ENVIRONMENT PROTECTION,1,ASSOCIATE PROJECT MANAGER,81443,110413,Annual,28970
247211,DEPARTMENT OF INVESTIGATION,1,CONFIDENTIAL INVESTIGATOR,48764,60000,Annual,11236
247365,DEPT OF HEALTH/MENTAL HYGIENE,1,CRIMINALIST,65089,65089,Annual,0
247266,ADMIN FOR CHILDREN'S SVCS,1,AGENCY ATTORNEY,57005,87027,Annual,30022
247300,FIRE DEPARTMENT,5,ASSOCIATE INSPECTOR (ELECTRICA,50463,71290,Annual,20827
248571,NYC HOUSING AUTHORITY,1,ADMIN CONTRACT SPECIALIST (PYR,135000,150000,Annual,15000
248642,ADMIN FOR CHILDREN'S SVCS,3,DIRECTOR OF FIELD OPERATIONS (,53051,145991,Annual,92940
248645,ADMIN FOR CHILDREN'S SVCS,2,DIRECTOR OF FIELD OPERATIONS (,53051,145991,Annual,92940
247328,DEPT OF ENVIRONMENT PROTECTION,2,WATERSHED MAINTAINER,37085,54243,Annual,17158
247343,DEPT OF HEALTH/MENTAL HYGIENE,1,CRIMINALIST,91216,91216,Annual,0
248918,DEPARTMENT OF CORRECTION,2,COMPUTER SYSTEMS MANAGER,110000,130000,Annual,20000
247352,DEPT OF HEALTH/MENTAL HYGIENE,1,CRIMINALIST,79787,79787,Annual,0
248920,DEPARTMENT OF CORRECTION,1,COMPUTER SYSTEMS MANAGER,100000,120000,Annual,20000
248646,ADMIN FOR CHILDREN'S SVCS,1,ADMINISTRATIVE DIRECTOR OF SOC,58675,156793,Annual,98118
248736,DEPARTMENT OF SANITATION,2,CERT IT DEVELOPER (APP),89383,134914,Annual,45531
247362,DEPT OF HEALTH/MENTAL HYGIENE,1,CRIMINALIST,55296,55296,Annual,0
247376,DEPT OF ENVIRONMENT PROTECTION,2,PROCUREMENT ANALYST,44945,72628,Annual,27683
248919,DEPARTMENT OF CORRECTION,4,COMPUTER SYSTEMS MANAGER,100000,120000,Annual,20000
247403,LAW DEPARTMENT,1,CLERICAL ASSOCIATE,32888,53281,Annual,20393
247406,HRA/DEPT OF SOCIAL SERVICES,3,COMMUNITY ASSOCIATE,34644,57655,Annual,23011
247532,DEPT OF ENVIRONMENT PROTECTION,3,DISTRICT SUPERVISOR (WATER & S,62194,91472,Annual,29278
248922,DEPARTMENT OF CORRECTION,1,COMPUTER SYSTEMS MANAGER,100000,120000,Annual,20000
246734,ADMIN FOR CHILDREN'S SVCS,1,ASSOCIATE STAFF ANALYST,63817,95022,Annual,31205
251156,DEPT OF DESIGN & CONSTRUCTION,4,ADMIN ARCHITECT (NON MGRL) M-1,48535,132061,Annual,83526
247852,DEPT OF ENVIRONMENT PROTECTION,1,CLERICAL ASSOCIATE,36166,56775,Annual,20609
247879,POLICE DEPARTMENT,2,INVESTIGATOR TRAINEE (PYRL NOT,29153,41267,Annual,12114
247886,DEPT OF ENVIRONMENT PROTECTION,1,ASSOCIATE PUBLIC HEALTH SANITA,60673,91795,Annual,31122
249055,DEPARTMENT OF SANITATION,1,CERT IT DEVELOPER (APP),89383,134914,Annual,45531
248000,HRA/DEPT OF SOCIAL SERVICES,1,COMMUNITY COORDINATOR,48895,56229,Annual,7334
249039,DEPT OF HEALTH/MENTAL HYGIENE,4,CRIMINALIST,59589,59589,Annual,0
249046,DEPARTMENT OF SANITATION,1,COMPUTER SPECIALIST (OPERATION,69253,108101,Annual,38848
249052,DEPARTMENT OF SANITATION,1,COMPUTER SPECIALIST (OPERATION,69253,108101,Annual,38848
246795,DEPT OF INFO TECH & TELECOMM,3,COMPUTER ASSOC (OPERATIONS),66300,80000,Annual,13700
249054,DEPARTMENT OF SANITATION,1,ADMINISTRATIVE SUPERVISOR OF B,53051,145991,Annual,92940
249058,DEPARTMENT OF SANITATION,1,CERT IT DEVELOPER (APP),89383,134914,Annual,45531
249060,DEPARTMENT OF SANITATION,1,CERT IT DEVELOPER (APP),89383,134914,Annual,45531
246812,DEPT OF DESIGN & CONSTRUCTION,1,COMPUTER PROGRAMMER ANALYST,55637,77953,Annual,22316
246814,DEPT OF INFO TECH & TELECOMM,1,SENIOR IT ARCHITECT,100000,130000,Annual,30000
249083,DEPT OF HEALTH/MENTAL HYGIENE,4,CRIMINALIST,59589,59589,Annual,0
246852,DEPT OF INFO TECH & TELECOMM,1,COMPUTER SPECIALIST (SOFTWARE),74066,90000,Annual,15934
253358,HRA/DEPT OF SOCIAL SERVICES,2,CITY RESEARCH SCIENTIST,57969,62000,Annual,4031
246873,OFFICE OF THE COMPTROLLER,1,ADMINISTRATIVE PROCUREMENT ANA,57517,65000,Annual,7483
249392,DEPT OF ENVIRONMENT PROTECTION,1,ADMINISTRATIVE PROJECT MANAGER,48535,134433,Annual,85898
251111,DEPARTMENT OF INVESTIGATION,1,CONFIDENTIAL INVESTIGATOR,48764,57400,Annual,8636
253540,HRA/DEPT OF SOCIAL SERVICES,2,COMPUTER SYSTEMS MANAGER,53051,145991,Annual,92940
251143,DEPT OF HEALTH/MENTAL HYGIENE,1,CITY RESEARCH SCIENTIST,68239,85644,Annual,17405
253555,HRA/DEPT OF SOCIAL SERVICES,1,COMPUTER SYSTEMS MANAGER,53051,145991,Annual,92940
251999,TAXI & LIMOUSINE COMMISSION,1,COMMUNITY COORDINATOR,48895,70000,Annual,21105
249490,DEPARTMENT OF FINANCE,1,COMPUTER ASSOC (SOFTWARE),69215,79597,Annual,10382
251310,LAW DEPARTMENT,1,PARALEGAL AIDE,39041,54633,Annual,15592
251373,DEPT OF ENVIRONMENT PROTECTION,1,CITY RESEARCH SCIENTIST,68239,85644,Annual,17405
249532,DEPT OF INFO TECH & TELECOMM,5,CERT IT ADMINISTRATOR (DB),83323,110000,Annual,26677
251374,CIVILIAN COMPLAINT REVIEW BD,1,EXECUTIVE AGENCY COUNSEL,85000,123000,Annual,38000
251508,DEPT OF YOUTH & COMM DEV SRVS,1,ASSOCIATE STAFF ANALYST,63817,95022,Annual,31205
249559,DEPARTMENT OF FINANCE,1,CITY RESEARCH SCIENTIST,68239,78475,Annual,10236
249577,DEPT OF INFO TECH & TELECOMM,1,IT AUTOMATION AND MONITORING E,75000,120000,Annual,45000
251619,FIRE DEPARTMENT,3,COMPUTER ASSOC (OPERATIONS),55556,82776,Annual,27220
251623,DEPT OF ENVIRONMENT PROTECTION,1,AGENCY ATTORNEY,71784,105974,Annual,34190
249725,DEPT OF DESIGN & CONSTRUCTION,1,ADMINISTRATIVE PROJECT MANAGER,58675,156793,Annual,98118
249732,DEPT OF ENVIRONMENT PROTECTION,2,SUPERVISOR (WATERSHED MAINTENA,57074,71502,Annual,14428
251630,DEPT OF ENVIRONMENT PROTECTION,1,COMMUNITY COORDINATOR,48895,75900,Annual,27005
251636,FIRE DEPARTMENT,1,IT PROJECT SPECIALIST,75000,125000,Annual,50000
251646,DEPT OF ENVIRONMENT PROTECTION,4,ENGINEERING TECHNICIAN,35183,45647,Annual,10464
249749,DEPT OF DESIGN & CONSTRUCTION,1,ADMINISTRATIVE ENGINEER,58675,156793,Annual,98118
251659,DEPT OF INFO TECH & TELECOMM,1,COMPUTER SYSTEMS MANAGER,60435,150000,Annual,89565
251746,FIRE DEPARTMENT,1,IT INFRASTRUCTURE ENGINEER,75000,110000,Annual,35000
251749,DEPARTMENT OF TRANSPORTATION,1,COMPUTER ASSOC (SOFTWARE),60189,83440,Annual,23251
251875,DEPT OF INFO TECH & TELECOMM,1,CERT IT ADMINISTRATOR (DB),83323,110000,Annual,26677
252002,CIVILIAN COMPLAINT REVIEW BD,1,INVESTIGATIVE MANAGER (CCRB),80000,100000,Annual,20000
250692,DEPT OF INFO TECH & TELECOMM,3,COMPUTER SPECIALIST (OPERATION,69253,105000,Annual,35747
252119,DEPT OF ENVIRONMENT PROTECTION,4,ASSISTANT CIVIL ENGINEER,51586,77404,Annual,25818
252127,DEPT OF ENVIRONMENT PROTECTION,1,MECHANICAL ENGINEER,72805,101148,Annual,28343
252466,BUSINESS INTEGRITY COMMISSION,3,COMMUNITY ASSOCIATE,40000,46655,Annual,6655
252522,DEPT OF INFO TECH & TELECOMM,1,SENIOR IT ARCHITECT,100000,130000,Annual,30000
250318,NYC HOUSING AUTHORITY,1,COMPUTER ASSOC (SOFTWARE),60189,83440,Annual,23251
253925,DEPT OF YOUTH & COMM DEV SRVS,1,MANAGEMENT AUDITOR,50623,80988,Annual,30365
250320,DEPARTMENT OF TRANSPORTATION,2,PRINCIPAL ADMINISTRATIVE ASSOC,47951,69703,Annual,21752
252635,BUSINESS INTEGRITY COMMISSION,3,COMMUNITY ASSOCIATE,35644,41000,Annual,5356
250368,DEPT OF ENVIRONMENT PROTECTION,1,ASSOCIATE PUBLIC HEALTH SANITA,60673,91795,Annual,31122
252731,DEPT OF ENVIRONMENT PROTECTION,8,ENGINEERING TECHNICIAN,35183,45647,Annual,10464
252976,DEPT OF INFO TECH & TELECOMM,1,COMPUTER ASSOC (SOFTWARE),61995,71294,Annual,9299
251044,DEPT OF ENVIRONMENT PROTECTION,19,ENVIRONMENTAL ENGINEERING INTE,46466,56270,Annual,9804
253811,DEPT OF INFO TECH & TELECOMM,1,COMPUTER SPECIALIST (SOFTWARE),83323,108101,Annual,24778
255778,DEPT OF ENVIRONMENT PROTECTION,1,ENGINEERING TECHNICIAN,38061,53977,Annual,15916
255817,ADMIN FOR CHILDREN'S SVCS,1,COMPUTER SYSTEMS MANAGER,53051,111946,Annual,58895
260009,ADMIN FOR CHILDREN'S SVCS,1,MECHANICAL ENGINEER,72805,101148,Annual,28343
254409,HRA/DEPT OF SOCIAL SERVICES,1,SPACE ANALYST,61237,70422,Annual,9185
260404,DEPT OF HEALTH/MENTAL HYGIENE,1,CRIMINALIST,59589,59589,Annual,0
260407,DEPT OF INFO TECH & TELECOMM,1,BUSINESS PROMOTION COORDINATOR,57976,70000,Annual,12024
256231,OFFICE OF THE COMPTROLLER,1,RESEARCH AND LIAISON COORDINAT,60000,80000,Annual,20000
256331,OFFICE OF THE COMPTROLLER,1,LABOR RELATIONS ANALYST TRAINE,45000,54075,Annual,9075
254254,HRA/DEPT OF SOCIAL SERVICES,1,COMPUTER SYSTEMS MANAGER,53051,145991,Annual,92940
256629,DEPARTMENT OF FINANCE,1,PRINCIPAL ADMINISTRATIVE ASSOC,42856,49284,Annual,6428
256709,DEPT OF ENVIRONMENT PROTECTION,5,SUPERVISOR (WATER & SEWER SYST,57074,87116,Annual,30042
256805,FIRE DEPARTMENT,1,COMPUTER ASSOC (SOFTWARE),60189,83440,Annual,23251
268157,OFFICE OF THE COMPTROLLER,1,BUSINESS PROMOTION COORDINATOR,50000,65000,Annual,15000
256838,DEPT OF ENVIRONMENT PROTECTION,1,PROCUREMENT ANALYST,44945,70000,Annual,25055
257538,DEPT OF ENVIRONMENT PROTECTION,1,INDUSTRIAL HYGIENIST,50649,68071,Annual,17422
257551,DEPT OF ENVIRONMENT PROTECTION,1,ADMINISTRATIVE PUBLIC HEALTH S,53051,145991,Annual,92940
254515,DEPARTMENT OF FINANCE,1,CITY PLANNING TECHNICIAN,35183,40461,Annual,5278
254594,DEPT OF ENVIRONMENT PROTECTION,1,ELECTRICAL ENGINEER,81443,110413,Annual,28970
254599,DEPT OF ENVIRONMENT PROTECTION,1,CIVIL ENGINEER,72805,101148,Annual,28343
257724,DEPT OF ENVIRONMENT PROTECTION,2,ASSISTANT MECHANICAL ENGINEER,51586,77404,Annual,25818
254600,DEPARTMENT OF INVESTIGATION,1,CONFIDENTIAL INVESTIGATOR,48764,60000,Annual,11236
257767,DEPARTMENT OF INVESTIGATION,1,CONFIDENTIAL INVESTIGATOR,62601,82444,Annual,19843
254915,HRA/DEPT OF SOCIAL SERVICES,30,PUBLIC HEALTH EDUCATOR,48447,52000,Annual,3553
257900,DEPT OF ENVIRONMENT PROTECTION,1,COMPUTER ASSOC (TECH SUPP),66434,102033,Annual,35599
255105,DEPT OF ENVIRONMENT PROTECTION,1,PRINCIPAL ADMINISTRATIVE ASSOC,42856,50000,Annual,7144
257907,DEPT OF ENVIRONMENT PROTECTION,1,COMPUTER ASSOC (TECH SUPP),46405,67568,Annual,21163
257952,DEPT OF INFO TECH & TELECOMM,1,COMPUTER SPECIALIST (OPERATION,69253,106795,Annual,37542
255347,DEPT OF INFO TECH & TELECOMM,2,COMPUTER SPECIALIST (OPERATION,69253,105000,Annual,35747
257953,CIVILIAN COMPLAINT REVIEW BD,2,COMMUNITY ASSOCIATE,34644,57655,Annual,23011
257988,HRA/DEPT OF SOCIAL SERVICES,8,PUBLIC HEALTH EDUCATOR,48447,54745,Annual,6298
269192,CONSUMER AFFAIRS,1,COMPUTER SYSTEMS MANAGER,54643,150371,Annual,95728
258215,DEPT OF ENVIRONMENT PROTECTION,1,ADM ENGINEER (NON MGRL),105000,106000,Annual,1000
255370,OFFICE OF THE COMPTROLLER,1,ADMINISTRATIVE MANAGEMENT AUDI,95000,105000,Annual,10000
259017,DEPT OF ENVIRONMENT PROTECTION,1,PROCUREMENT ANALYST,37411,63456,Annual,26045
259420,HRA/DEPT OF SOCIAL SERVICES,1,STAFF NURSE,71669,71669,Annual,0
259423,HRA/DEPT OF SOCIAL SERVICES,1,STAFF NURSE,71669,71669,Annual,0
259471,ADMIN FOR CHILDREN'S SVCS,1,ADMINISTRATIVE DIRECTOR OF SOC,58675,114673,Annual,55998
253700,DEPT OF ENVIRONMENT PROTECTION,1,WATERSHED MAINTAINER,37085,54243,Annual,17158
253736,DEPT OF ENVIRONMENT PROTECTION,2,WATERSHED MAINTAINER,37085,54243,Annual,17158
253756,DEPT OF ENVIRONMENT PROTECTION,2,WATERSHED MAINTAINER,37085,54243,Annual,17158
253780,DEPT OF INFO TECH & TELECOMM,2,COMPUTER SPECIALIST (SOFTWARE),89383,123773,Annual,34390
259832,HRA/DEPT OF SOCIAL SERVICES,2,STAFF NURSE,71669,71669,Annual,0
260005,HRA/DEPT OF SOCIAL SERVICES,1,SOCIAL WORKER,46163,65635,Annual,19472
253794,DEPT OF INFO TECH & TELECOMM,1,COMPUTER SPECIALIST (SOFTWARE),89383,120000,Annual,30617
260479,ADMIN FOR CHILDREN'S SVCS,1,CHILD WELFARE SPECIALIST,46995,71984,Annual,24989
262212,DEPT OF DESIGN & CONSTRUCTION,1,ADMINISTRATIVE ENGINEER,60435,161497,Annual,101062
262252,DEPT OF DESIGN & CONSTRUCTION,2,CONSTRUCTION PROJECT MANAGER,67083,113725,Annual,46642
262352,DEPT OF DESIGN & CONSTRUCTION,2,ESTIMATOR (GENERAL CONSTRUCTIO,53134,79726,Annual,26592
263569,ADMIN TRIALS AND HEARINGS,1,ADMINISTRATIVE LAW JUDGE,90000,130000,Annual,40000
263606,FIRE DEPARTMENT,1,COMPUTER SPECIALIST (SOFTWARE),79471,95000,Annual,15529
262366,DEPT OF DESIGN & CONSTRUCTION,3,SENIOR ESTIMATOR (GENERAL CONS,63074,91347,Annual,28273
262372,DEPT OF INFO TECH & TELECOMM,1,IT INFRASTRUCTURE ENGINEER,75000,117775,Annual,42775
262378,DEPT OF DESIGN & CONSTRUCTION,5,ASSOCIATE URBAN DESIGNER,63074,91347,Annual,28273
263640,DEPT OF INFO TECH & TELECOMM,1,SENIOR IT ARCHITECT,100000,125000,Annual,25000
262379,DEPT OF DESIGN & CONSTRUCTION,1,PRINCIPAL ADMINISTRATIVE ASSOC,47951,69703,Annual,21752
262545,DEPT OF YOUTH & COMM DEV SRVS,1,STOCK WORKER,33350,49864,Annual,16514
262549,ADMIN FOR CHILDREN'S SVCS,1,ADMINISTRATIVE DIRECTOR OF SOC,54643,99509,Annual,44866
260538,ADMIN FOR CHILDREN'S SVCS,2,COMMUNITY COORDINATOR,50362,78177,Annual,27815
260707,DEPT OF HEALTH/MENTAL HYGIENE,3,FORENSIC MORTUARY TECHNICIAN,51072,58733,Annual,7661
262657,DEPARTMENT OF CORRECTION,3,DIRECTOR OF CORRECTIONAL STAND,160000,180000,Annual,20000
260758,ADMIN FOR CHILDREN'S SVCS,1,COMMUNITY COORDINATOR,50362,71471,Annual,21109
260759,DEPT OF ENVIRONMENT PROTECTION,1,COMPUTER SYSTEMS MANAGER,60435,161497,Annual,101062
262895,DEPT OF ENVIRONMENT PROTECTION,1,ASSISTANT CIVIL ENGINEER,53134,79726,Annual,26592
262940,DEPARTMENT OF PROBATION,1,AGENCY ATTORNEY,66326,99394,Annual,33068
260974,ADMIN FOR CHILDREN'S SVCS,2,COMMUNITY COORDINATOR,50362,71471,Annual,21109
263031,DEPARTMENT OF TRANSPORTATION,1,COMPUTER ASSOC (TECH SUPP),55667,81782,Annual,26115
261347,ADMIN FOR CHILDREN'S SVCS,1,PROGRAM EVALUATOR (ACS),61850,91678,Annual,29828
261127,DEPT OF ENVIRONMENT PROTECTION,2,ASSOCIATE PUBLIC HEALTH SANITA,60673,91795,Annual,31122
263058,DEPARTMENT OF TRANSPORTATION,1,COMPUTER ASSOC (OPERATIONS),68289,104364,Annual,36075
263104,DEPT OF DESIGN & CONSTRUCTION,1,COMMUNITY COORDINATOR,50362,78177,Annual,27815
261284,DEPARTMENT OF TRANSPORTATION,1,ADMINISTRATIVE PROJECT MANAGER,160000,190000,Annual,30000
261438,DEPARTMENT OF TRANSPORTATION,5,CIVIL ENGINEER,74990,104182,Annual,29192
263328,ADMIN FOR CHILDREN'S SVCS,1,SUPERVISOR OF NURSES,79271,79271,Annual,0
263380,DEPT OF ENVIRONMENT PROTECTION,2,GARDENER,40410,58161,Annual,17751
261530,DEPARTMENT OF CORRECTION,6,INVESTIGATOR(DISCP)(ONLY FOR P,47084,55000,Annual,7916
261753,DEPT. OF HOMELESS SERVICES,1,ADMINISTRATIVE CONSTRUCTION PR,75338,194395,Annual,119057
263388,DEPT OF DESIGN & CONSTRUCTION,5,ARCHITECT,63074,91347,Annual,28273
263393,DEPT OF ENVIRONMENT PROTECTION,1,CIVIL ENGINEERING INTERN,47860,57958,Annual,10098
263473,DEPT OF ENVIRONMENT PROTECTION,1,COMPUTER PROGRAMMER ANALYST,47692,65847,Annual,18155
261720,DEPARTMENT OF SANITATION,1,STOCK WORKER,33350,49864,Annual,16514
263413,DEPT OF INFO TECH & TELECOMM,1,ADMINISTRATIVE PUBLIC INFORMAT,54643,100000,Annual,45357
261769,DEPT. OF HOMELESS SERVICES,1,ADMINISTRATIVE CONSTRUCTION PR,75338,194395,Annual,119057
261862,DEPARTMENT OF TRANSPORTATION,1,ADMINISTRATIVE PROJECT MANAGER,60435,135000,Annual,74565
263439,FIRE DEPARTMENT,2,COMPUTER SPECIALIST (SOFTWARE),85823,111344,Annual,25521
262030,DEPARTMENT FOR THE AGING,1,ADMINISTRATIVE  PROGRAM OFFICE,72000,80000,Annual,8000
262065,DEPT OF INFO TECH & TELECOMM,1,COMPUTER SYSTEMS MANAGER,60435,125000,Annual,64565
262070,FIRE DEPARTMENT,1,COMPUTER SPECIALIST (SOFTWARE),79471,95000,Annual,15529
263447,DEPT OF HEALTH/MENTAL HYGIENE,1,EVIDENCE AND PROPERTY CONTROL,46404,52437,Annual,6033
263487,DEPARTMENT OF FINANCE,2,ACCOUNTANT,52143,80000,Annual,27857
262154,DEPT OF DESIGN & CONSTRUCTION,1,STAFF ANALYST,48620,66195,Annual,17575
263987,CIVILIAN COMPLAINT REVIEW BD,1,COMMUNITY COORDINATOR,50362,78177,Annual,27815
263853,DEPT OF ENVIRONMENT PROTECTION,2,CITY RESEARCH SCIENTIST,70286,88213,Annual,17927
264699,ADMIN FOR CHILDREN'S SVCS,8,PROGRAM EVALUATOR (ACS),61850,91678,Annual,29828
265498,DEPT OF ENVIRONMENT PROTECTION,1,CIVIL ENGINEER,74990,104182,Annual,29192
265499,ADMIN FOR CHILDREN'S SVCS,1,COMMUNITY COORDINATOR,50362,70902,Annual,20540
265518,DEPARTMENT FOR THE AGING,1,ASSISTANT ARCHITECT,53134,79726,Annual,26592
264706,DEPT OF DESIGN & CONSTRUCTION,3,COMMUNITY COORDINATOR,50362,78177,Annual,27815
264707,ADMIN FOR CHILDREN'S SVCS,1,PROGRAM EVALUATOR (ACS),61850,91678,Annual,29828
265558,ADMIN FOR CHILDREN'S SVCS,1,COMPUTER SYSTEMS MANAGER,54643,111946,Annual,57303
264795,DEPARTMENT OF TRANSPORTATION,2,HIGHWAY TRANSPORTATION SPECIAL,53134,79726,Annual,26592
264862,DEPT OF HEALTH/MENTAL HYGIENE,1,PROCUREMENT ANALYST,46069,74444,Annual,28375
263950,DEPT OF INFO TECH & TELECOMM,2,COMPUTER ASSOC (OPERATIONS),47692,54846,Annual,7154
264868,DEPT OF DESIGN & CONSTRUCTION,5,MECHANICAL ENGINEER,63074,91347,Annual,28273
264934,DEPT OF HEALTH/MENTAL HYGIENE,1,COMMUNITY COORDINATOR,50362,78177,Annual,27815
264066,OFFICE OF THE COMPTROLLER,1,ADMINISTRATIVE PUBLIC INFORMAT,70000,90000,Annual,20000
274610,HOUSING PRESERVATION & DVLPMNT,1,ESTIMATOR (GENERAL CONSTRUCTIO,61104,71112,Annual,10008
264979,ADMIN FOR CHILDREN'S SVCS,1,COMMUNITY COORDINATOR,50362,71471,Annual,21109
264981,DEPT OF INFO TECH & TELECOMM,1,BUSINESS PROMOTION COORDINATOR,59715,70000,Annual,10285
264218,DEPT OF ENVIRONMENT PROTECTION,1,ELECTRICAL ENGINEER,74990,104182,Annual,29192
279778,DEPT OF INFO TECH & TELECOMM,2,COMPUTER SPECIALIST (OPERATION,71330,88000,Annual,16670
264246,ADMIN FOR CHILDREN'S SVCS,1,COMMUNITY COORDINATOR,50362,71471,Annual,21109
264990,DEPT OF INFO TECH & TELECOMM,1,ASSOCIATE INSPECTOR (CONSUMERS,57885,75000,Annual,17115
264417,DEPT OF DESIGN & CONSTRUCTION,5,CIVIL ENGINEER,63074,91347,Annual,28273
264430,DEPT OF DESIGN & CONSTRUCTION,5,ADMINISTRATIVE PROJECT MANAGER,48535,134433,Annual,85898
264440,NYC HOUSING AUTHORITY,1,LANDSCAPE ARCHITECT,63074,91347,Annual,28273
264992,ADMIN FOR CHILDREN'S SVCS,3,CONSTRUCTION PROJECT MANAGER,63074,91347,Annual,28273
264994,ADMIN FOR CHILDREN'S SVCS,1,CHILD AND FAMILY SPECIALIST,67980,91678,Annual,23698
264498,DEPARTMENT OF TRANSPORTATION,1,PRINCIPAL ADMINISTRATIVE ASSOC,53047,81068,Annual,28021
265178,HRA/DEPT OF SOCIAL SERVICES,1,COMPUTER ASSOC (SOFTWARE),66751,92908,Annual,26157
264507,DEPARTMENT OF TRANSPORTATION,1,CLERICAL ASSOCIATE,37251,58478,Annual,21227
264508,DEPT OF DESIGN & CONSTRUCTION,2,ASSOCIATE URBAN DESIGNER,72590,110038,Annual,37448
265179,DEPARTMENT OF TRANSPORTATION,1,COMPUTER SPECIALIST (SOFTWARE),92065,127486,Annual,35421
265194,DEPT OF ENVIRONMENT PROTECTION,3,ENGINEERING TECHNICIAN,36239,47016,Annual,10777
264510,DEPARTMENT OF TRANSPORTATION,3,CLERICAL ASSOCIATE,33875,54879,Annual,21004
265244,DEPARTMENT OF CITY PLANNING,1,COMMUNITY COORDINATOR,65000,78000,Annual,13000
265245,ADMIN FOR CHILDREN'S SVCS,1,COMMUNITY COORDINATOR,50362,70902,Annual,20540
265251,ADMIN FOR CHILDREN'S SVCS,1,CHILD WELFARE SPECIALIST SUPER,62734,85126,Annual,22392
264542,ADMIN FOR CHILDREN'S SVCS,1,CHILD AND FAMILY SPECIALIST,67980,91678,Annual,23698
264572,DEPT OF ENVIRONMENT PROTECTION,1,ADMINISTRATIVE PROJECT MANAGER,48535,134433,Annual,85898
265347,DEPT OF PARKS & RECREATION,8,ASSISTANT LANDSCAPE ARCHITECT,53134,61104,Annual,7970
264651,DEPT OF ENVIRONMENT PROTECTION,5,CITY PARK WORKER,32317,50197,Annual,17880
265350,HRA/DEPT OF SOCIAL SERVICES,1,COMPUTER SYSTEMS MANAGER,54643,150371,Annual,95728
265352,FIRE DEPARTMENT,1,TELECOMMUNICATION MANAGER,54643,125000,Annual,70357
264661,ADMIN FOR CHILDREN'S SVCS,1,CHILD WELFARE SPECIALIST SUPER,62734,85126,Annual,22392
265393,DEPT OF PARKS & RECREATION,3,LANDSCAPE ARCHITECT,65000,72535,Annual,7535
263653,DEPARTMENT OF SANITATION,1,CERTIFIED IT ADMINISTRATOR (LA,92065,138961,Annual,46896
265416,POLICE DEPARTMENT,1,COMPUTER ASSOC (SOFTWARE),66751,92908,Annual,26157
265468,ADMIN FOR CHILDREN'S SVCS,1,CHILD AND FAMILY SPECIALIST,67980,91678,Annual,23698
263662,DEPARTMENT OF FINANCE,2,MANAGEMENT AUDITOR,60375,85000,Annual,24625
263674,NYC EMPLOYEES RETIREMENT SYS,1,COMPUTER SPECIALIST (SOFTWARE),79471,102388,Annual,22917
265478,ADMIN FOR CHILDREN'S SVCS,1,CHILD AND FAMILY SPECIALIST,67980,91678,Annual,23698
263741,DEPARTMENT OF FINANCE,1,PRINCIPAL ADMINISTRATIVE ASSOC,53047,67000,Annual,13953
266420,DEPT OF DESIGN & CONSTRUCTION,2,ADMINISTRATIVE PROJECT MANAGER,48535,134433,Annual,85898
267594,LAW DEPARTMENT,1,COMPUTER AIDE,38157,49394,Annual,11237
266453,DEPT OF PARKS & RECREATION,2,ADMINISTRATIVE PROJECT MANAGER,85000,105000,Annual,20000
267526,DEPT OF INFO TECH & TELECOMM,1,COMPUTER SYSTEMS MANAGER,67060,175000,Annual,107940
267598,DEPARTMENT OF INVESTIGATION,1,CONFIDENTIAL INVESTIGATOR,59791,70000,Annual,10209
267610,DEPARTMENT OF TRANSPORTATION,1,COMPUTER SPECIALIST (SOFTWARE),76288,95077,Annual,18789
267645,DEPARTMENT OF CITY PLANNING,1,COMMUNITY COORDINATOR,55000,65000,Annual,10000
266461,DEPARTMENT OF TRANSPORTATION,1,COMMUNITY COORDINATOR,50362,78177,Annual,27815
266471,DEPARTMENT OF TRANSPORTATION,1,CONFIDENTIAL STRATEGY PLANNER,55752,93845,Annual,38093
265651,CONSUMER AFFAIRS,1,COMMUNITY ASSOCIATE,35683,45000,Annual,9317
266499,DEPT OF DESIGN & CONSTRUCTION,2,ADM ENGINEER (NON MGRL),49990,136023,Annual,86033
266506,DEPT OF PARKS & RECREATION,10,URBAN PARK RANGER,41242,41242,Annual,0
266574,DEPT OF ENVIRONMENT PROTECTION,3,SUPERVISOR OF STOCK WORKERS,35951,55526,Annual,19575
266529,LAW DEPARTMENT,1,STUDENT LEGAL SPECIALIST,36270,41710,Annual,5440
265740,LAW DEPARTMENT,1,COMPUTER ASSOC (TECH SUPP),46405,67568,Annual,21163
266542,NYC EMPLOYEES RETIREMENT SYS,1,COMPUTER SYSTEMS MANAGER,54643,150371,Annual,95728
265810,DEPT OF INFO TECH & TELECOMM,1,COMPUTER SPECIALIST (OPERATION,71330,97571,Annual,26241
265826,HRA/DEPT OF SOCIAL SERVICES,1,COMPUTER ASSOC (SOFTWARE),66751,92908,Annual,26157
266603,DEPARTMENT OF TRANSPORTATION,1,COMPUTER SPECIALIST (SOFTWARE),85823,111344,Annual,25521
266606,DEPARTMENT OF TRANSPORTATION,1,COMPUTER SPECIALIST (SOFTWARE),92065,127486,Annual,35421
266801,OFFICE OF MANAGEMENT & BUDGET,1,BUDGET ANALYST (OMB),43618,65433,Annual,21815
266864,ADMIN TRIALS AND HEARINGS,1,COMMUNITY ASSOCIATE,35683,59385,Annual,23702
265868,FIRE DEPARTMENT,1,COMPUTER ASSOC (SOFTWARE),66751,92908,Annual,26157
267001,DEPARTMENT FOR THE AGING,1,SUPERVISOR III WELFARE,61850,91678,Annual,29828
265939,DEPARTMENT OF PROBATION,1,ADMINISTRATIVE PROCUREMENT ANA,54643,150371,Annual,95728
267174,DEPT OF ENVIRONMENT PROTECTION,1,ADMINISTRATIVE ENGINEER,100000,125000,Annual,25000
267194,CIVILIAN COMPLAINT REVIEW BD,1,DEPUTY ASSISTANT DIRECTOR (CIV,80000,100000,Annual,20000
265912,ADMIN FOR CHILDREN'S SVCS,1,STAFF NURSE,71669,71669,Annual,0
265926,DEPARTMENT OF CORRECTION,25,RECREATION DIRECTOR,40000,45000,Annual,5000
267286,HOUSING PRESERVATION & DVLPMNT,1,COMPUTER ASSOC (OPERATIONS),81060,90000,Annual,8940
267298,DEPT OF HEALTH/MENTAL HYGIENE,2,CITY MEDICAL EXAMINER (OCME),135503,174240,Annual,38737
265951,DEPARTMENT OF FINANCE,1,EXECUTIVE AGENCY COUNSEL,82790,175000,Annual,92210
265952,MANHATTAN COMMUNITY BOARD #11,1,ASSISTANT DISTRICT MANAGER (CO,37497,45000,Annual,7503
266380,DEPT OF ENVIRONMENT PROTECTION,1,ASSISTANT CIVIL ENGINEER,53134,79726,Annual,26592
267306,DEPT OF HEALTH/MENTAL HYGIENE,2,CITY MEDICAL EXAMINER (OCME),164533,207432,Annual,42899
269115,DEPT OF DESIGN & CONSTRUCTION,1,COMPUTER PROGRAMMER ANALYST,55637,77953,Annual,22316
266176,POLICE DEPARTMENT,1,COMPUTER SYSTEMS MANAGER,54643,150371,Annual,95728
266220,DEPT OF DESIGN & CONSTRUCTION,2,MECHANICAL ENGINEER,63074,91347,Annual,28273
268632,DEPARTMENT OF TRANSPORTATION,1,CIVIL ENGINEER,83887,113725,Annual,29838
266372,DEPT OF ENVIRONMENT PROTECTION,2,ADM CITY PLANNER (NON MGRL),49990,80000,Annual,30010
267407,LAW DEPARTMENT,2,ASSISTANT CORPORATION COUNSEL,68494,88325,Annual,19831
266397,DEPT OF DESIGN & CONSTRUCTION,2,CIVIL ENGINEER,63074,91347,Annual,28273
267432,DEPT OF ENVIRONMENT PROTECTION,1,PROCUREMENT ANALYST,46069,74444,Annual,28375
267497,OFF OF PAYROLL ADMINISTRATION,1,ADMINISTRATIVE ACCOUNTANT,54643,83000,Annual,28357
266408,DEPT OF PARKS & RECREATION,8,LANDSCAPE ARCHITECT,84000,97000,Annual,13000
266412,DEPT OF INFO TECH & TELECOMM,1,ADM CONSTRUCTION PRJ MGR-NM,49990,90000,Annual,40010
267801,DEPT OF INFO TECH & TELECOMM,1,SUPERVISOR OF RADIO AND TELEVI,62910,84738,Annual,21828
267825,DEPT OF CITYWIDE ADMIN SVCS,1,ADMINISTRATIVE PROCUREMENT ANA,58955,80000,Annual,21045
267838,DEPARTMENT FOR THE AGING,1,ADMINISTRATIVE PUBLIC INFORMAT,54643,150371,Annual,95728
267899,DEPT OF DESIGN & CONSTRUCTION,5,CONSTRUCTION PROJECT MANAGER,67083,113725,Annual,46642
267852,ADMIN FOR CHILDREN'S SVCS,1,COMMUNITY COORDINATOR,50362,71471,Annual,21109
268307,DEPT OF HEALTH/MENTAL HYGIENE,1,CLERICAL ASSOCIATE,30580,35098,Annual,4518
268983,DEPT OF ENVIRONMENT PROTECTION,1,INSTRUMENTATION SPECIALIST,57310,59633,Annual,2323
268312,DEPARTMENT OF FINANCE,1,COMPUTER ASSOC (TECH SUPP),66434,86000,Annual,19566
268332,DEPARTMENT OF INVESTIGATION,1,PRINCIPAL ADMINISTRATIVE ASSOC,42856,57822,Annual,14966
269175,DEPARTMENT OF PROBATION,3,COMMUNITY COORDINATOR,50362,78177,Annual,27815
268333,DEPARTMENT OF TRANSPORTATION,1,COMPUTER SPECIALIST (SOFTWARE),92065,127486,Annual,35421
267903,CONFLICTS OF INTEREST BOARD,1,AGENCY ATTORNEY,58716,89638,Annual,30922
268432,TAXI & LIMOUSINE COMMISSION,1,STAFF ANALYST,48620,66195,Annual,17575
267922,DEPT OF INFO TECH & TELECOMM,1,COMPUTER ASSOC (OPERATIONS),57223,75761,Annual,18538
267935,FIRE DEPARTMENT,1,IT INFRASTRUCTURE ENGINEER,75000,120000,Annual,45000
267942,HOUSING PRESERVATION & DVLPMNT,1,COMPUTER ASSOC (OPERATIONS),78532,85000,Annual,6468
268471,DEPT OF ENVIRONMENT PROTECTION,1,ASSOCIATE PROJECT MANAGER,83887,113725,Annual,29838
268545,DEPARTMENT FOR THE AGING,1,AGENCY CHIEF CONTRACTING OFFIC,67060,178873,Annual,111813
268700,ADMIN FOR CHILDREN'S SVCS,1,PROGRAM EVALUATOR (ACS),61850,91678,Annual,29828
267990,DEPT OF PARKS & RECREATION,1,ASSISTANT CIVIL ENGINEER,60000,70000,Annual,10000
268768,DEPT OF ENVIRONMENT PROTECTION,1,CITY RESEARCH SCIENTIST,70286,88213,Annual,17927
267998,DEPT OF PARKS & RECREATION,1,LANDSCAPE ARCHITECT,75000,88000,Annual,13000
268011,DEPT OF PARKS & RECREATION,3,ARCHITECT,90000,100000,Annual,10000
268803,DEPARTMENT OF TRANSPORTATION,4,ADMINISTRATIVE PROJECT MANAGER,48535,105000,Annual,56465
268031,DEPARTMENT OF INVESTIGATION,1,COMMUNITY ASSOCIATE,35683,47509,Annual,11826
268082,DEPT OF DESIGN & CONSTRUCTION,5,CIVIL ENGINEER,63074,91347,Annual,28273
268842,DEPT OF ENVIRONMENT PROTECTION,2,COMPUTER ASSOC (TECH SUPP),55667,81782,Annual,26115
268867,ADMIN FOR CHILDREN'S SVCS,1,COMMUNITY COORDINATOR,50362,59559,Annual,9197
268879,ADMIN FOR CHILDREN'S SVCS,1,CHILD WELFARE SPECIALIST,48405,65677,Annual,17272
268147,OFFICE OF THE COMPTROLLER,1,BUSINESS PROMOTION COORDINATOR,40000,50000,Annual,10000
268880,ADMIN FOR CHILDREN'S SVCS,2,DIRECTOR OF FIELD OPERATIONS (,60435,103044,Annual,42609
268886,ADMIN FOR CHILDREN'S SVCS,1,DIRECTOR OF FIELD OPERATIONS (,67060,108951,Annual,41891
268905,ADMIN FOR CHILDREN'S SVCS,4,DIRECTOR OF FIELD OPERATIONS (,54643,94478,Annual,39835
267726,ADMIN FOR CHILDREN'S SVCS,1,ADMINISTRATIVE DIRECTOR OF SOC,54643,99509,Annual,44866
268916,DEPT OF INFO TECH & TELECOMM,1,COMPUTER SPECIALIST (OPERATION,71330,94446,Annual,23116
267746,OFF OF PAYROLL ADMINISTRATION,1,PRINCIPAL ADMINISTRATIVE ASSOC,53047,81068,Annual,28021
267770,DEPT OF INFO TECH & TELECOMM,1,SENIOR IT ARCHITECT,100000,150000,Annual,50000
267783,DEPARTMENT OF INVESTIGATION,1,INSPECTOR GENERAL,80000,113000,Annual,33000
269182,CIVILIAN COMPLAINT REVIEW BD,1,DEPUTY EXECUTIVE DIRECTOR (CIV,125000,165000,Annual,40000
269971,TAXI & LIMOUSINE COMMISSION,1,AGENCY ATTORNEY,66326,80000,Annual,13674
270042,DEPT OF ENVIRONMENT PROTECTION,1,SUPERVISOR (WATERSHED MAINTENA,58786,73647,Annual,14861
271048,DEPT OF ENVIRONMENT PROTECTION,1,PORT MARINE ENGINEER,76640,108080,Annual,31440
270088,DEPARTMENT OF TRANSPORTATION,1,CIVIL ENGINEER,74990,104182,Annual,29192
271074,ADMIN FOR CHILDREN'S SVCS,1,ADMINISTRATIVE DIRECTOR OF SOC,54643,99509,Annual,44866
270068,DEPARTMENT OF FINANCE,1,COMPUTER SYSTEMS MANAGER,60435,120000,Annual,59565
270073,POLICE DEPARTMENT,9,HOSTLER,32496,44807,Annual,12311
271155,ADMIN TRIALS AND HEARINGS,2,AGENCY ATTORNEY,66326,80000,Annual,13674
270096,POLICE DEPARTMENT,5,AUTOMOTIVE SERVICE WORKER,32885,38245,Annual,5360
269194,DEPT OF DESIGN & CONSTRUCTION,2,ACCOUNTANT,46747,63519,Annual,16772
269201,DEPT OF DESIGN & CONSTRUCTION,2,ACCOUNTANT,52143,83418,Annual,31275
270098,POLICE DEPARTMENT,81,AUTOMOTIVE SERVICE WORKER,32885,38245,Annual,5360
270142,DEPARTMENT OF SANITATION,1,ADMINISTRATIVE PROJECT MANAGER,54643,150371,Annual,95728
269278,DEPARTMENT OF SANITATION,1,COMMUNITY COORDINATOR,50362,78177,Annual,27815
269306,DEPT OF ENVIRONMENT PROTECTION,1,ELECTRICAL ENGINEER,63074,91347,Annual,28273
270151,DEPT OF YOUTH & COMM DEV SRVS,1,ASSOCIATE STAFF ANALYST,63817,95022,Annual,31205
269452,DEPT OF ENVIRONMENT PROTECTION,1,CIVIL ENGINEER,74990,104182,Annual,29192
270169,DEPT OF YOUTH & COMM DEV SRVS,1,ADMINISTRATIVE PROCUREMENT ANA,60435,161497,Annual,101062
269319,FIRE DEPARTMENT,1,SUPERVISOR OF STOCK WORKERS,42190,64723,Annual,22533
269935,TAXI & LIMOUSINE COMMISSION,2,STAFF ANALYST,48620,66195,Annual,17575
269947,TAXI & LIMOUSINE COMMISSION,8,AGENCY ATTORNEY INTERNE,57944,70353,Annual,12409
270212,DEPARTMENT OF FINANCE,1,COMPUTER SPECIALIST (SOFTWARE),85823,103000,Annual,17177
270213,DEPARTMENT OF FINANCE,1,COMPUTER SPECIALIST (SOFTWARE),85823,99000,Annual,13177
270232,DEPT. OF HOMELESS SERVICES,10,SOCIAL WORKER,54967,61000,Annual,6033
269397,ADMIN FOR CHILDREN'S SVCS,5,DIRECTOR OF FIELD OPERATIONS (,54643,150371,Annual,95728
270353,POLICE DEPARTMENT,85,EVIDENCE AND PROPERTY CONTROL,46404,66423,Annual,20019
269431,DEPT OF ENVIRONMENT PROTECTION,1,CIVIL ENGINEER,83887,113725,Annual,29838
269449,HRA/DEPT OF SOCIAL SERVICES,1,SUPERVISOR I SOCIAL WORK,52917,60854,Annual,7937
270363,DEPT. OF HOMELESS SERVICES,1,COMPUTER SYSTEMS MANAGER,54643,150371,Annual,95728
270378,DEPT. OF HOMELESS SERVICES,1,COMMUNITY COORDINATOR,50362,78177,Annual,27815
270384,OFFICE OF THE COMPTROLLER,1,RESEARCH AND LIAISON COORDINAT,60435,80000,Annual,19565
269466,DEPT OF ENVIRONMENT PROTECTION,1,MECHANICAL ENGINEER,63074,91347,Annual,28273
269559,FINANCIAL INFO SVCS AGENCY,1,IT AUTOMATION AND MONITORING E,75000,109000,Annual,34000
270496,DEPARTMENT OF TRANSPORTATION,1,ASSISTANT URBAN DESIGNER,53134,79726,Annual,26592
270535,DEPARTMENT OF TRANSPORTATION,1,COMMUNITY COORDINATOR,50362,78177,Annual,27815
269594,DEPT. OF HOMELESS SERVICES,7,FRAUD INVESTIGATOR,38617,66136,Annual,27519
269680,DEPT. OF HOMELESS SERVICES,1,SOCIAL WORKER,47549,67604,Annual,20055
270929,DEPT. OF HOMELESS SERVICES,1,CITY RESEARCH SCIENTIST,78630,103332,Annual,24702
270931,DEPT OF DESIGN & CONSTRUCTION,3,CIVIL ENGINEER,83887,113725,Annual,29838
269885,DEPT OF ENVIRONMENT PROTECTION,1,MECHANICAL ENGINEERING INTERN,52000,52000,Annual,0
270955,DEPT OF ENVIRONMENT PROTECTION,1,CITY RESEARCH SCIENTIST,59708,72246,Annual,12538
269904,DEPT OF YOUTH & COMM DEV SRVS,1,ASSOCIATE CONTRACT SPECIALIST,56033,80000,Annual,23967
270964,DEPT OF ENVIRONMENT PROTECTION,1,CITY RESEARCH SCIENTIST,70286,88213,Annual,17927
271397,FIRE DEPARTMENT,1,CITY RESEARCH SCIENTIST,78630,103332,Annual,24702
271437,DEPT OF DESIGN & CONSTRUCTION,3,ASSOCIATE PROJECT MANAGER,69491,101848,Annual,32357
271986,HRA/DEPT OF SOCIAL SERVICES,1,COMPUTER SPECIALIST (SOFTWARE),85823,111344,Annual,25521
272447,DEPARTMENT OF TRANSPORTATION,1,MECHANICAL ENGINEER,63074,91347,Annual,28273
272161,NYC HOUSING AUTHORITY,1,AGENCY ATTORNEY,66326,99394,Annual,33068
272162,PRESIDENT BOROUGH OF MANHATTAN,1,ADMINISTRATIVE CITY PLANNER,55000,55000,Annual,0
272463,DEPARTMENT OF TRANSPORTATION,1,CONSTRUCTION PROJECT MANAGER,67083,113725,Annual,46642
272475,DEPARTMENT OF TRANSPORTATION,1,PRINCIPAL ADMINISTRATIVE ASSOC,47951,69703,Annual,21752
271539,DEPARTMENT OF BUSINESS SERV.,1,BUSINESS PROMOTION COORDINATOR,39399,67744,Annual,28345
271592,DEPT OF INFO TECH & TELECOMM,1,IT INFRASTRUCTURE ENGINEER,75000,128000,Annual,53000
272168,DEPARTMENT OF FINANCE,1,COMMUNITY COORDINATOR,50362,78177,Annual,27815
272170,NYC HOUSING AUTHORITY,1,ADMIN CONTRACT SPECIALIST (PYR,135000,150000,Annual,15000
271598,DEPT OF ENVIRONMENT PROTECTION,1,STAFF ANALYST,56458,72310,Annual,15852
271639,HRA/DEPT OF SOCIAL SERVICES,1,COMPUTER SPECIALIST (SOFTWARE),79471,91392,Annual,11921
271648,NYC HOUSING AUTHORITY,1,SENIOR INTERGROUP RELATIONS OF,52260,52260,Annual,0
271653,DEPT OF ENVIRONMENT PROTECTION,1,CONSTRUCTION PROJECT MANAGER,63074,91347,Annual,28273
272297,DEPT OF ENVIRONMENT PROTECTION,1,EXECUTIVE AGENCY COUNSEL,60435,161497,Annual,101062
271673,DEPT OF INFO TECH & TELECOMM,1,IT SECURITY SPECIALIST,75000,95077,Annual,20077
271691,DEPT OF INFO TECH & TELECOMM,1,IT INFRASTRUCTURE ENGINEER,75000,115000,Annual,40000
271686,DEPT OF DESIGN & CONSTRUCTION,5,ADMINISTRATIVE PROJECT MANAGER,48535,134433,Annual,85898
271817,DEPT OF DESIGN & CONSTRUCTION,1,ADM ENGINEER (NON MGRL),49990,136023,Annual,86033
272348,ADMIN FOR CHILDREN'S SVCS,1,AGENCY ATTORNEY,73938,99390,Annual,25452
271873,DEPARTMENT OF TRANSPORTATION,1,CIVIL ENGINEER,83887,113725,Annual,29838
272382,DEPT OF ENVIRONMENT PROTECTION,1,ASSOCIATE PUBLIC HEALTH SANITA,60673,91795,Annual,31122
271877,DEPARTMENT OF TRANSPORTATION,1,ACCOUNTANT,52143,83418,Annual,31275
272384,HOUSING PRESERVATION & DVLPMNT,2,CONSTRUCTION PROJECT MANAGER,63074,82000,Annual,18926
271878,DEPARTMENT OF TRANSPORTATION,2,MANAGEMENT AUDITOR,52143,83418,Annual,31275
271899,DEPARTMENT OF FINANCE,1,ADMINISTRATIVE ACCOUNTANT,54643,95000,Annual,40357
272403,DEPARTMENT OF TRANSPORTATION,1,COMPUTER SPECIALIST (SOFTWARE),92065,127486,Annual,35421
272406,DEPARTMENT OF TRANSPORTATION,2,ADMINISTRATIVE PROJECT MANAGER,85000,105000,Annual,20000
271955,ADMIN FOR CHILDREN'S SVCS,1,DIRECTOR OF FIELD OPERATIONS (,54643,150371,Annual,95728
272425,DEPARTMENT OF TRANSPORTATION,1,COMPUTER SPECIALIST (SOFTWARE),92065,127486,Annual,35421
272428,HOUSING PRESERVATION & DVLPMNT,1,EXECUTIVE AGENCY COUNSEL,144500,154500,Annual,10000
272429,DEPARTMENT OF TRANSPORTATION,1,COMPUTER SPECIALIST (SOFTWARE),92065,127486,Annual,35421
272433,DEPARTMENT OF TRANSPORTATION,1,COMPUTER ASSOC (SOFTWARE),61995,85943,Annual,23948
271257,DEPT OF HEALTH/MENTAL HYGIENE,1,AGENCY MEDICAL DIRECTOR,91070,215942,Annual,124872
272698,HOUSING PRESERVATION & DVLPMNT,2,SUPERVISOR OF MECHANICAL INSTA,63074,72535,Annual,9461
272437,DEPARTMENT OF TRANSPORTATION,1,COMPUTER SPECIALIST (SOFTWARE),92065,127486,Annual,35421
271271,DEPARTMENT OF CORRECTION,20,CLERICAL ASSOCIATE,42839,50000,Annual,7161
272705,HOUSING PRESERVATION & DVLPMNT,1,SUPERVISOR OF MECHANICAL INSTA,63074,72535,Annual,9461
272765,DEPT OF INFO TECH & TELECOMM,2,COMPUTER PROGRAMMER ANALYST,47692,55000,Annual,7308
272784,BOARD OF CORRECTION,1,EXECUTIVE AGENCY COUNSEL,80000,120000,Annual,40000
273122,CONSUMER AFFAIRS,1,AGENCY ATTORNEY,58716,80000,Annual,21284
273128,HOUSING PRESERVATION & DVLPMNT,2,CITY PLANNER,65000,74223,Annual,9223
272796,DEPT OF YOUTH & COMM DEV SRVS,1,CONTRACT SPECIALIST,47598,57000,Annual,9402
272818,DEPT OF INFO TECH & TELECOMM,1,COMMUNITY ASSOCIATE,35683,56249,Annual,20566
272828,DEPT OF ENVIRONMENT PROTECTION,1,ADMINISTRATIVE PROJECT MANAGER,48535,134433,Annual,85898
272871,POLICE DEPARTMENT,1,BOOKBINDER,34447,55364,Annual,20917
272863,FIRE DEPARTMENT,1,COMPUTER SPECIALIST (SOFTWARE),79471,102388,Annual,22917
272507,DEPT OF HEALTH/MENTAL HYGIENE,1,COMPUTER SYSTEMS MANAGER,54643,150371,Annual,95728
272524,TAX COMMISSION,2,PRINCIPAL ADMINISTRATIVE ASSOC,42856,62779,Annual,19923
272553,HOUSING PRESERVATION & DVLPMNT,1,COMMUNITY COORDINATOR,60000,65000,Annual,5000
272586,DEPT OF ENVIRONMENT PROTECTION,1,WATERSHED MAINTAINER,38197,55870,Annual,17673
272938,DEPT OF HEALTH/MENTAL HYGIENE,1,CRIMINALIST,76516,76516,Annual,0
272951,DEPT OF INFO TECH & TELECOMM,1,SENIOR IT ARCHITECT,100000,150000,Annual,50000
272602,POLICE DEPARTMENT,1,ADMINISTRATIVE PSYCHOLOGIST,75338,194395,Annual,119057
272608,DEPARTMENT OF SANITATION,1,CERT IT DEVELOPER (APP),92065,138961,Annual,46896
272957,DEPT OF INFO TECH & TELECOMM,1,COMMUNITY ASSOCIATE,35683,59385,Annual,23702
272609,DEPT OF DESIGN & CONSTRUCTION,3,ESTIMATOR (GENERAL CONSTRUCTIO,53134,79726,Annual,26592
272617,ADMIN FOR CHILDREN'S SVCS,4,CHILD WELFARE SPECIALIST SUPER,75520,76674,Annual,1154
272993,DEPT OF ENVIRONMENT PROTECTION,1,COMMUNITY COORDINATOR,50362,78177,Annual,27815
272995,DEPARTMENT OF INVESTIGATION,1,PROCUREMENT ANALYST,37411,63456,Annual,26045
273025,DEPARTMENT OF BUILDINGS,20,ASSISTANT PLAN EXAMINER (BLDGS,55538,65000,Annual,9462
273052,DEPT OF INFO TECH & TELECOMM,2,CERT IT DEVELOPER (APP),79471,105000,Annual,25529
272660,MAYORS OFFICE OF CONTRACT SVCS,1,RESEARCH PROJECTS COOR(MA)-MGR,60000,80000,Annual,20000
273053,CIVILIAN COMPLAINT REVIEW BD,4,EXECUTIVE AGENCY COUNSEL,70000,90000,Annual,20000
273054,DEPARTMENT OF INVESTIGATION,1,CONFIDENTIAL INVESTIGATOR,50227,60000,Annual,9773
272661,OFFICE OF THE COMPTROLLER,1,EXECUTIVE AGENCY COUNSEL,90000,100000,Annual,10000
272692,HRA/DEPT OF SOCIAL SERVICES,1,ADMINISTRATIVE STAFF ANALYST (,58675,75000,Annual,16325
273063,DEPARTMENT OF SANITATION,1,PRINCIPAL ADMINISTRATIVE ASSOC,42856,62779,Annual,19923
272713,DEPARTMENT OF BUSINESS SERV.,1,ADMIN CONTRACT SPECIALIST (PYR,60435,161497,Annual,101062
272725,MAYORS OFFICE OF CONTRACT SVCS,1,RESEARCH PROJECTS COOR(MA)-MGR,70000,95000,Annual,25000
273120,DEPT OF PARKS & RECREATION,1,COMMUNITY COORDINATOR,70000,75000,Annual,5000
272745,DEPT OF INFO TECH & TELECOMM,2,IT SECURITY SPECIALIST,75000,100000,Annual,25000
272747,DEPARTMENT OF INVESTIGATION,1,CONFIDENTIAL INVESTIGATOR,50227,63345,Annual,13118
273297,DEPT OF CITYWIDE ADMIN SVCS,1,PRINCIPAL ADMINISTRATIVE ASSOC,47951,69703,Annual,21752
273759,DEPARTMENT OF SANITATION,1,CIVIL ENGINEER,74990,104182,Annual,29192
273760,OFFICE OF THE COMPTROLLER,1,ADMINISTRATIVE PROJECT MANAGER,95000,105000,Annual,10000
273776,DEPT OF DESIGN & CONSTRUCTION,1,PRINCIPAL ADMINISTRATIVE ASSOC,47951,69703,Annual,21752
273337,DEPARTMENT OF FINANCE,1,COMPUTER PROGRAMMER ANALYST,47692,54846,Annual,7154
273332,POLICE DEPARTMENT,3,AUTO BODY WORKER,45624,58908,Annual,13284
273601,DEPT OF DESIGN & CONSTRUCTION,3,ASSOCIATE PROJECT MANAGER,69491,101848,Annual,32357
273602,HRA/DEPT OF SOCIAL SERVICES,2,CITY RESEARCH SCIENTIST,70286,83000,Annual,12714
273611,DEPT OF DESIGN & CONSTRUCTION,3,ASSOCIATE PROJECT MANAGER,69491,101848,Annual,32357
273613,DEPT OF DESIGN & CONSTRUCTION,2,ASSOCIATE PROJECT MANAGER,69491,101848,Annual,32357
273339,ADMIN TRIALS AND HEARINGS,1,COMPUTER SYSTEMS MANAGER,110000,110000,Annual,0
273619,DEPT OF DESIGN & CONSTRUCTION,2,ADMINISTRATIVE PROJECT MANAGER,48535,134433,Annual,85898
273347,DEPT OF CITYWIDE ADMIN SVCS,42,CITY SECURITY AIDE,30245,40108,Annual,9863
273707,TAXI & LIMOUSINE COMMISSION,1,COMPUTER SYSTEMS MANAGER,54643,100000,Annual,45357
273486,DEPT. OF HOMELESS SERVICES,1,ADMINISTRATIVE DIRECTOR OF SOC,67060,178873,Annual,111813
273520,TAXI & LIMOUSINE COMMISSION,1,ADMINISTRATIIVE TAXI & LIMOUSI,67060,130000,Annual,62940
273717,HOUSING PRESERVATION & DVLPMNT,1,COMMUNITY COORDINATOR,60000,65000,Annual,5000
273166,MAYORS OFFICE OF CONTRACT SVCS,1,RESEARCH PROJECTS COOR(MA)-MGR,80000,100000,Annual,20000
273201,DEPARTMENT OF FINANCE,1,ADMINISTRATIVE ACCOUNTANT,67060,108000,Annual,40940
273727,DEPARTMENT OF TRANSPORTATION,1,STRATEGIC INITIATIVE SPECIALIS,51190,93845,Annual,42655
273734,DEPARTMENT OF TRANSPORTATION,1,CONFIDENTIAL STRATEGY PLANNER,55752,93845,Annual,38093
273242,DEPT OF ENVIRONMENT PROTECTION,4,ADMINISTRATIVE PROJECT MANAGER,48535,134433,Annual,85898
273740,MAYORS OFFICE OF CONTRACT SVCS,1,RESEARCH PROJECTS COOR(MA)-MGR,70000,90000,Annual,20000
273220,HOUSING PRESERVATION & DVLPMNT,1,COMPUTER SPECIALIST (OPERATION,78500,85000,Annual,6500
276376,DEPT OF INFO TECH & TELECOMM,1,COMPUTER SYSTEMS MANAGER,82790,200000,Annual,117210
273742,MAYORS OFFICE OF CONTRACT SVCS,1,RESEARCH PROJECTS COOR(MA)-MGR,70000,110000,Annual,40000
273748,DEPT OF ENVIRONMENT PROTECTION,1,ADMINISTRATIVE PROJECT MANAGER,106000,106000,Annual,0
273780,DEPT OF HEALTH/MENTAL HYGIENE,1,ASSOCIATE LABORATORY MICROBIOL,54094,75271,Annual,21177
273957,DEPT OF ENVIRONMENT PROTECTION,1,ASSOCIATE LABORATORY MICROBIOL,65289,86234,Annual,20945
274483,DEPT. OF HOMELESS SERVICES,10,FRAUD INVESTIGATOR,38617,66136,Annual,27519
274408,HRA/DEPT OF SOCIAL SERVICES,1,SOCIAL WORKER,47549,67604,Annual,20055
274064,DEPT OF ENVIRONMENT PROTECTION,1,ADMINISTRATIVE PROJECT MANAGER,48535,134433,Annual,85898
273822,DEPT OF HEALTH/MENTAL HYGIENE,1,CITY RESEARCH SCIENTIST,90084,130939,Annual,40855
274504,DEPT OF ENVIRONMENT PROTECTION,3,ASSISTANT CIVIL ENGINEER,53134,79726,Annual,26592
274071,DEPARTMENT OF INVESTIGATION,1,ADMINISTRATIVE PUBLIC INFORMAT,75338,190000,Annual,114662
274076,DEPT OF DESIGN & CONSTRUCTION,1,ADMINISTRATIVE PROCUREMENT ANA,58955,137203,Annual,78248
274077,CONFLICTS OF INTEREST BOARD,1,EXECUTIVE AGENCY COUNSEL,150000,180000,Annual,30000
274079,MAYORS OFFICE OF CONTRACT SVCS,1,RESEARCH PROJECTS COOR(MA)-MGR,65000,80000,Annual,15000
273882,DEPARTMENT OF TRANSPORTATION,3,AUTOMOTIVE SERVICE WORKER,32885,38245,Annual,5360
273885,DEPT OF ENVIRONMENT PROTECTION,1,ADMINISTRATIVE PROJECT MANAGER,110000,120000,Annual,10000
273895,DEPT OF ENVIRONMENT PROTECTION,1,ADMINISTRATIVE PROJECT MANAGER,48535,134433,Annual,85898
274124,DEPT OF ENVIRONMENT PROTECTION,3,ASSISTANT CIVIL ENGINEER,53134,79726,Annual,26592
274540,DEPT OF ENVIRONMENT PROTECTION,4,ENGINEERING TECHNICIAN,45617,67206,Annual,21589
274131,DEPT OF INFO TECH & TELECOMM,1,COMPUTER ASSOC (OPERATIONS),57223,82030,Annual,24807
274466,DEPT OF DESIGN & CONSTRUCTION,1,ADMINISTRATIVE PROJECT MANAGER,67060,178873,Annual,111813
274574,HOUSING PRESERVATION & DVLPMNT,1,SENIOR ESTIMATOR (GENERAL CONS,63074,82000,Annual,18926
274154,CONSUMER AFFAIRS,4,INSPECTOR (CONSUMER AFFAIRS),39570,45505,Annual,5935
274156,DEPARTMENT OF TRANSPORTATION,1,ASSOCIATE URBAN DESIGNER,69491,101848,Annual,32357
274256,DEPARTMENT OF TRANSPORTATION,1,CITY PLANNER,68229,99672,Annual,31443
273935,DEPARTMENT OF TRANSPORTATION,15,DECKHAND,46412,53374,Annual,6962
274298,DEPARTMENT OF FINANCE,1,COMPUTER SPECIALIST (SOFTWARE),85823,105000,Annual,19177
274320,DEPT OF YOUTH & COMM DEV SRVS,1,COMPUTER SYSTEMS MANAGER,60435,125000,Annual,64565
274334,DEPT OF HEALTH/MENTAL HYGIENE,1,COMPUTER SYSTEMS MANAGER,100000,115000,Annual,15000
273941,DEPARTMENT OF PROBATION,2,SENIOR MENTAL HEALTH WORKER,33121,44422,Annual,11301
275109,HOUSING PRESERVATION & DVLPMNT,2,CONSTRUCTION PROJECT MANAGER,53134,75500,Annual,22366
275127,DEPARTMENT OF SANITATION,1,PROCUREMENT ANALYST,37411,63456,Annual,26045
274537,DEPT OF INFO TECH & TELECOMM,1,ADM MANAGER-NON-MGRL FRM M1/M2,49748,110000,Annual,60252
274538,DEPARTMENT OF TRANSPORTATION,1,EXECUTIVE AGENCY COUNSEL,67060,178873,Annual,111813
274768,HUMAN RIGHTS COMMISSION,8,HUMAN RIGHTS SPECIALIST (COMM,45959,72950,Annual,26991
274539,DEPT OF ENVIRONMENT PROTECTION,2,LANDSCAPE ARCHITECT INTERN,47860,57958,Annual,10098
274553,DEPARTMENT OF TRANSPORTATION,1,COMPUTER ASSOC (SOFTWARE),61995,85943,Annual,23948
274845,DEPT OF ENVIRONMENT PROTECTION,1,ADM ENGINEER (NON MGRL),90000,105000,Annual,15000
274559,DEPARTMENT OF SANITATION,1,COMPUTER SPECIALIST (SOFTWARE),76288,95077,Annual,18789
274821,DEPT OF HEALTH/MENTAL HYGIENE,1,SUPERVISOR OF MOTOR TRANSPORT,47581,53766,Annual,6185
274560,DEPARTMENT OF TRANSPORTATION,1,AGENCY ATTORNEY,66326,99394,Annual,33068
274562,DEPARTMENT OF TRANSPORTATION,1,AGENCY ATTORNEY,73938,109153,Annual,35215
274826,DEPT OF ENVIRONMENT PROTECTION,1,ASSOCIATE PROJECT MANAGER,83887,113725,Annual,29838
274579,DEPT OF ENVIRONMENT PROTECTION,10,SUPERVISOR (WATER & SEWER SYST,58786,89729,Annual,30943
274580,HOUSING PRESERVATION & DVLPMNT,1,ASSISTANT CIVIL ENGINEER,53134,74114,Annual,20980
274831,HOUSING PRESERVATION & DVLPMNT,1,COMMUNITY COORDINATOR,55373,65373,Annual,10000
274581,FINANCIAL INFO SVCS AGENCY,1,IT PROJECT SPECIALIST,75000,95000,Annual,20000
274615,DEPARTMENT OF INVESTIGATION,1,CONFIDENTIAL INVESTIGATOR,41996,60000,Annual,18004
274644,HUMAN RIGHTS COMMISSION,8,HUMAN RIGHTS SPECIALIST (COMM,45959,72950,Annual,26991
274881,HUMAN RIGHTS COMMISSION,1,DEP COMMISSIONER FOR COMMUNITY,67060,178873,Annual,111813
274983,CONSUMER AFFAIRS,1,COMPUTER SYSTEMS MANAGER,54643,150371,Annual,95728
274676,HUMAN RIGHTS COMMISSION,1,EXECUTIVE DIRECTOR,54643,150371,Annual,95728
274691,DEPT OF YOUTH & COMM DEV SRVS,1,COMPUTER SYSTEMS MANAGER,60435,161497,Annual,101062
274999,CIVILIAN COMPLAINT REVIEW BD,1,EXECUTIVE PROGRAM SPECIALIST (,80000,115000,Annual,35000
274415,OFFICE OF THE COMPTROLLER,1,COMPUTER SYSTEMS MANAGER,100000,125000,Annual,25000
275044,TAXI & LIMOUSINE COMMISSION,1,EXECUTIVE AGENCY COUNSEL,100000,130000,Annual,30000
274437,FINANCIAL INFO SVCS AGENCY,2,COMPUTER ASSOC (OPERATIONS),47692,69493,Annual,21801
275089,DEPT OF INFO TECH & TELECOMM,1,COMPUTER ASSOC (TECH SUPP),46405,53366,Annual,6961
275096,HOUSING PRESERVATION & DVLPMNT,1,COMPUTER ASSOC (OPERATIONS),80000,90000,Annual,10000
275130,DEPT OF ENVIRONMENT PROTECTION,1,CLERICAL ASSOCIATE,37251,58478,Annual,21227
275131,CONSUMER AFFAIRS,1,AGENCY ATTORNEY,66326,76275,Annual,9949
276405,DEPT OF INFO TECH & TELECOMM,1,COMPUTER SYSTEMS MANAGER,82790,200000,Annual,117210
275797,HOUSING PRESERVATION & DVLPMNT,1,ADMINISTRATIVE LABOR RELATIONS,80000,110000,Annual,30000
275668,DEPT OF ENVIRONMENT PROTECTION,1,CITY RESEARCH SCIENTIST,59708,72246,Annual,12538
275679,DEPT OF ENVIRONMENT PROTECTION,1,ENGINEERING TECHNICIAN,36239,47016,Annual,10777
275149,HOUSING PRESERVATION & DVLPMNT,1,COMPUTER SYSTEMS MANAGER,102000,112000,Annual,10000
275188,HOUSING PRESERVATION & DVLPMNT,1,ASSOCIATE HOUSING DEVELOPMENT,69491,77539,Annual,8048
275687,DEPARTMENT OF CITY PLANNING,1,CITY PLANNER,68229,85000,Annual,16771
275193,DEPT OF ENVIRONMENT PROTECTION,1,CLERICAL ASSOCIATE,42839,55000,Annual,12161
275715,DEPT OF ENVIRONMENT PROTECTION,2,CITY RESEARCH SCIENTIST,70286,88213,Annual,17927
275756,TAXI & LIMOUSINE COMMISSION,1,COMPUTER SYSTEMS MANAGER,90000,100000,Annual,10000
275359,DEPT OF ENVIRONMENT PROTECTION,1,AGENCY ATTORNEY,66326,92000,Annual,25674
281011,DEPT OF INFO TECH & TELECOMM,1,COMPUTER SYSTEMS MANAGER,54643,140000,Annual,85357
275397,DEPT OF ENVIRONMENT PROTECTION,2,ASSISTANT CIVIL ENGINEER,53134,79726,Annual,26592
275763,OFFICE OF THE COMPTROLLER,1,ADMINISTRATIVE PROCUREMENT ANA,70000,80000,Annual,10000
275770,OFFICE OF THE COMPTROLLER,1,ADMINISTRATIVE PROCUREMENT ANA,70000,80000,Annual,10000
275773,OFFICE OF THE COMPTROLLER,2,ADMINISTRATIVE PROCUREMENT ANA,60000,72000,Annual,12000
275583,DEPT OF PARKS & RECREATION,1,SENIOR ESTIMATOR (GENERAL CONS,72000,79000,Annual,7000
275606,DEPT OF DESIGN & CONSTRUCTION,1,ADMINISTRATIVE STAFF ANALYST (,65107,173663,Annual,108556
275785,LAW DEPARTMENT,1,PARALEGAL AIDE,40212,56272,Annual,16060
275884,DEPT. OF HOMELESS SERVICES,2,SOCIAL WORKER,47549,67604,Annual,20055
275896,FIRE DEPARTMENT,1,COMPUTER SPECIALIST (SOFTWARE),79471,102388,Annual,22917
275897,DEPARTMENT OF TRANSPORTATION,1,ASSISTANT CIVIL ENGINEER,53134,79726,Annual,26592
276013,DEPARTMENT OF TRANSPORTATION,1,CIVIL ENGINEER,63074,91347,Annual,28273
276014,DEPARTMENT OF TRANSPORTATION,1,ASSISTANT CIVIL ENGINEER,53134,79726,Annual,26592
276321,DEPARTMENT OF TRANSPORTATION,1,ASSOCIATE PROJECT MANAGER,69491,101848,Annual,32357
276333,HRA/DEPT OF SOCIAL SERVICES,10,COMMUNITY ASSOCIATE,35683,52983,Annual,17300
276335,HRA/DEPT OF SOCIAL SERVICES,2,COMMUNITY COORDINATOR,50362,63345,Annual,12983
276336,DEPARTMENT OF TRANSPORTATION,2,COMMUNITY COORDINATOR,50362,78177,Annual,27815
276022,ADMIN FOR CHILDREN'S SVCS,1,CLERICAL ASSOCIATE,33875,46495,Annual,12620
276025,DEPT OF HEALTH/MENTAL HYGIENE,2,FORENSIC MORTUARY TECHNICIAN,38930,38930,Annual,0
276046,HRA/DEPT OF SOCIAL SERVICES,1,CONSTRUCTION PROJECT MANAGER,63074,91347,Annual,28273
276051,DEPT OF YOUTH & COMM DEV SRVS,1,ASSOCIATE CONTRACT SPECIALIST,56033,84435,Annual,28402
276056,DEPT OF YOUTH & COMM DEV SRVS,1,ASSOCIATE CONTRACT SPECIALIST,56033,84435,Annual,28402
275919,FIRE DEPARTMENT,1,COMPUTER ASSOC (OPERATIONS),57223,85259,Annual,28036
276072,DEPT OF YOUTH & COMM DEV SRVS,1,ASSOCIATE CONTRACT SPECIALIST,56033,84435,Annual,28402
276085,DEPT OF ENVIRONMENT PROTECTION,1,STAFF ANALYST,56458,72310,Annual,15852
275925,FIRE DEPARTMENT,1,COMPUTER SPECIALIST (SOFTWARE),76288,95077,Annual,18789
275946,FIRE DEPARTMENT,1,COMPUTER SPECIALIST (SOFTWARE),79471,102388,Annual,22917
276133,DEPT OF ENVIRONMENT PROTECTION,2,ENVIRONMENTAL ENGINEERING INTE,52000,52000,Annual,0
276135,DEPT OF ENVIRONMENT PROTECTION,1,ENVIRONMENTAL ENGINEERING INTE,52000,52000,Annual,0
276202,DEPT OF DESIGN & CONSTRUCTION,1,ADMINISTRATIVE STAFF ANALYST (,58675,156793,Annual,98118
276204,DEPT OF HEALTH/MENTAL HYGIENE,1,PUBLIC HEALTH EMERGENCY PREPAR,45250,74500,Annual,29250
275957,DEPARTMENT OF TRANSPORTATION,1,CITY PLANNER,68229,99672,Annual,31443
276247,OFFICE OF EMERGENCY MANAGEMENT,1,EMERGENCY PREPAREDNESS SPECIAL,62000,62000,Annual,0
276252,DEPT OF ENVIRONMENT PROTECTION,3,ASSISTANT CIVIL ENGINEER,53134,79726,Annual,26592
276256,DEPT OF HEALTH/MENTAL HYGIENE,1,CITY RESEARCH SCIENTIST,70286,88213,Annual,17927
276258,DEPT OF HEALTH/MENTAL HYGIENE,5,CRIMINALIST,76516,76516,Annual,0
276007,LAW DEPARTMENT,20,PARALEGAL AIDE,40212,56272,Annual,16060
276261,DEPT OF HEALTH/MENTAL HYGIENE,10,CRIMINALIST,76516,76516,Annual,0
275844,DEPT. OF HOMELESS SERVICES,1,CITY RESEARCH SCIENTIST,59708,72246,Annual,12538
276262,DEPARTMENT FOR THE AGING,1,COMMUNITY COORDINATOR,60000,65000,Annual,5000
276264,DEPT OF ENVIRONMENT PROTECTION,1,ADMINISTRATIVE PROJECT MANAGER,75338,194395,Annual,119057
276347,DEPT OF INFO TECH & TELECOMM,1,COMPUTER SYSTEMS MANAGER,82790,200000,Annual,117210
276267,DEPARTMENT FOR THE AGING,1,PROGRAM OFFICER (DEPT FOR THE,52917,76413,Annual,23496
276268,DEPARTMENT FOR THE AGING,1,PROGRAM OFFICER (DEPT FOR THE,52917,76413,Annual,23496
275846,DEPT OF DESIGN & CONSTRUCTION,3,COMMUNITY ASSOCIATE,35683,59385,Annual,23702
276278,HOUSING PRESERVATION & DVLPMNT,1,EXECUTIVE AGENCY COUNSEL,80000,110000,Annual,30000
276306,DEPT OF INFO TECH & TELECOMM,1,COMPUTER SYSTEMS MANAGER,54643,92627,Annual,37984
275858,DEPT. OF HOMELESS SERVICES,1,CITY RESEARCH SCIENTIST,70286,88213,Annual,17927
275861,LAW DEPARTMENT,15,STUDENT LEGAL SPECIALIST,36270,41710,Annual,5440
276311,DEPT OF ENVIRONMENT PROTECTION,1,COMPUTER ASSOC (OPERATIONS),47692,69493,Annual,21801
275870,FIRE DEPARTMENT,2,COMPUTER SPECIALIST (SOFTWARE),79471,102388,Annual,22917
276618,DEPT OF YOUTH & COMM DEV SRVS,1,ADMINISTRATIVE STAFF ANALYST (,75338,100000,Annual,24662
276370,HRA/DEPT OF SOCIAL SERVICES,1,PUBLIC HEALTH EDUCATOR,48447,54745,Annual,6298
276371,LAW DEPARTMENT,2,ASSISTANT CORPORATION COUNSEL,70959,143046,Annual,72087
276626,DEPARTMENT OF INVESTIGATION,1,CONFIDENTIAL INVESTIGATOR,41996,60223,Annual,18227
276627,DISTRICT ATTORNEY RICHMOND COU,1,ASSISTANT DISTRICT ATTORNEY (S,72000,90000,Annual,18000
276375,TAXI & LIMOUSINE COMMISSION,1,ASSOCIATE STAFF ANALYST,63817,95022,Annual,31205
276643,DISTRICT ATTORNEY RICHMOND COU,2,ASSISTANT DISTRICT ATTORNEY (S,67500,73500,Annual,6000
276648,LAW DEPARTMENT,1,CLERICAL ASSOCIATE,33875,54879,Annual,21004
276649,DEPT OF INFO TECH & TELECOMM,3,IT SECURITY SPECIALIST,75000,110000,Annual,35000
276652,DEPT OF INFO TECH & TELECOMM,2,COMPUTER SYSTEMS MANAGER,67060,175000,Annual,107940
276442,ADMIN FOR CHILDREN'S SVCS,1,PRINCIPAL ADMINISTRATIVE ASSOC,47951,69703,Annual,21752
276446,DISTRICT ATTORNEY RICHMOND COU,1,ASSISTANT DISTRICT ATTORNEY (S,120000,150000,Annual,30000
276457,HOUSING PRESERVATION & DVLPMNT,1,COMMUNITY COORDINATOR,57916,65000,Annual,7084
276678,DEPT OF ENVIRONMENT PROTECTION,2,WATERSHED MAINTAINER,38197,55870,Annual,17673
276679,DEPT OF ENVIRONMENT PROTECTION,1,STAFF ANALYST,56458,72310,Annual,15852
276478,TAXI & LIMOUSINE COMMISSION,1,CLERICAL ASSOCIATE,33875,54879,Annual,21004
276680,DEPT OF ENVIRONMENT PROTECTION,1,STAFF ANALYST,56458,72310,Annual,15852
276684,DEPT OF ENVIRONMENT PROTECTION,1,CITY PLANNER,60702,89359,Annual,28657
276504,DEPT OF HEALTH/MENTAL HYGIENE,2,CRIMINALIST,88287,88287,Annual,0
276700,FIRE DEPARTMENT,2,COMPUTER SPECIALIST (SOFTWARE),79471,102388,Annual,22917
276702,DEPARTMENT OF CITY PLANNING,1,CITY PLANNER,52000,62000,Annual,10000
277063,DEPARTMENT OF TRANSPORTATION,1,ADMINISTRATIVE PROJECT MANAGER,48535,134433,Annual,85898
276715,FIRE DEPARTMENT,2,COMPUTER SPECIALIST (SOFTWARE),79471,102388,Annual,22917
276736,DEPT OF ENVIRONMENT PROTECTION,1,CITY RESEARCH SCIENTIST,78630,103332,Annual,24702
276540,OFFICE OF THE COMPTROLLER,1,BUSINESS PROMOTION COORDINATOR,65000,80000,Annual,15000
276543,OFFICE OF THE COMPTROLLER,1,ADMINISTRATIVE BUSINESS PROMOT,90000,120000,Annual,30000
276549,DEPT OF INFO TECH & TELECOMM,1,COMPUTER SYSTEMS MANAGER,67060,160000,Annual,92940
276763,FIRE DEPARTMENT,1,COMPUTER SPECIALIST (SOFTWARE),79471,102388,Annual,22917
276594,DEPT OF INFO TECH & TELECOMM,1,COMPUTER SPECIALIST (OPERATION,71330,108100,Annual,36770
277107,DEPT OF DESIGN & CONSTRUCTION,2,COMPUTER SERVICE TECHNICIAN (C,38157,49394,Annual,11237
277318,HOUSING PRESERVATION & DVLPMNT,1,ASSOCIATE HOUSING DEVELOPMENT,85000,100000,Annual,15000
277319,DEPARTMENT OF TRANSPORTATION,1,INVESTIGATOR (EMPLOYEE DISCIPL,39381,60223,Annual,20842
277129,FIRE DEPARTMENT,4,AUTOMOTIVE SERVICE WORKER,38509,49034,Annual,10525
277182,OFF OF PAYROLL ADMINISTRATION,1,ADMINISTRATIVE STAFF ANALYST (,70213,125000,Annual,54787
277324,DEPT OF ENVIRONMENT PROTECTION,3,ASSOCIATE PROJECT MANAGER,83887,113725,Annual,29838
277347,HRA/DEPT OF SOCIAL SERVICES,1,SUPERVISOR I SOCIAL WORK,52917,76413,Annual,23496
277352,DEPARTMENT OF BUILDINGS,30,INSPECTOR (CONSTRUCTION),49862,61800,Annual,11938
276874,DEPT OF HEALTH/MENTAL HYGIENE,1,CRIMINALIST,48277,48277,Annual,0
276881,DEPT OF ENVIRONMENT PROTECTION,1,MECHANICAL ENGINEER,63074,91347,Annual,28273
277190,CONSUMER AFFAIRS,1,CITY RESEARCH SCIENTIST,78630,100000,Annual,21370
277204,FINANCIAL INFO SVCS AGENCY,1,ADMINISTRATIVE STAFF ANALYST (,89283,180000,Annual,90717
276889,DEPT OF ENVIRONMENT PROTECTION,3,ASSISTANT CIVIL ENGINEER,53134,79726,Annual,26592
276892,DEPARTMENT OF TRANSPORTATION,1,CLERICAL ASSOCIATE,33875,54879,Annual,21004
277218,CONSUMER AFFAIRS,1,EXECUTIVE AGENCY COUNSEL,75338,113300,Annual,37962
276932,DEPT OF YOUTH & COMM DEV SRVS,1,ADMINISTRATIVE COMMUNITY RELAT,75338,194395,Annual,119057
276945,HRA/DEPT OF SOCIAL SERVICES,1,COMPUTER SYSTEMS MANAGER,54643,150371,Annual,95728
276958,DEPT OF YOUTH & COMM DEV SRVS,1,COMPUTER SYSTEMS MANAGER,91070,215942,Annual,124872
276966,FIRE DEPARTMENT,1,PUBLIC RECORDS OFFICER,41045,58972,Annual,17927
276967,TAXI & LIMOUSINE COMMISSION,1,CERT IT ADMINISTRATOR (DB),76288,87731,Annual,11443
276982,DEPT OF ENVIRONMENT PROTECTION,1,ADMINISTRATIVE PROJECT MANAGER,48535,134433,Annual,85898
276987,DEPT OF ENVIRONMENT PROTECTION,1,ASSISTANT ELECTRICAL ENGINEER,53134,79726,Annual,26592
276838,DEPT OF ENVIRONMENT PROTECTION,1,CIVIL ENGINEER,74990,104182,Annual,29192
277021,DEPARTMENT OF TRANSPORTATION,1,ASSOCIATE STAFF ANALYST,63817,95022,Annual,31205
277264,LAW DEPARTMENT,1,IT SECURITY SPECIALIST,75000,180000,Annual,105000
277282,DEPT OF DESIGN & CONSTRUCTION,1,ADMINISTRATIVE STAFF ANALYST (,58675,156793,Annual,98118
277036,DEPARTMENT OF TRANSPORTATION,1,ASSISTANT CIVIL ENGINEER,53134,79726,Annual,26592
277285,DEPT OF DESIGN & CONSTRUCTION,1,ADMINISTRATIVE PROJECT MANAGER,48535,134433,Annual,85898
277286,DEPT OF DESIGN & CONSTRUCTION,1,ADM MANAGER-NON-MGRL FRM M1/M2,49748,145991,Annual,96243
276840,DEPT OF ENVIRONMENT PROTECTION,2,MECHANICAL ENGINEER,74990,104182,Annual,29192
277369,TAXI & LIMOUSINE COMMISSION,1,CLERICAL ASSOCIATE,33875,43800,Annual,9925
277306,DEPARTMENT OF BUSINESS SERV.,1,CONTRACT REVIEWER (OFFICE OF L,45455,70193,Annual,24738
276849,HRA/DEPT OF SOCIAL SERVICES,1,COMMUNITY COORDINATOR,50362,78177,Annual,27815
277366,DEPARTMENT OF INVESTIGATION,1,CONFIDENTIAL INVESTIGATOR,50227,58000,Annual,7773
277316,DEPARTMENT OF TRANSPORTATION,1,AGENCY ATTORNEY,58716,89638,Annual,30922
277372,DEPT OF ENVIRONMENT PROTECTION,1,PROJECT MANAGER INTERN#,47974,55170,Annual,7196
277687,HOUSING PRESERVATION & DVLPMNT,1,COMPUTER ASSOC (OPERATIONS),77500,87500,Annual,10000
277696,NYC HOUSING AUTHORITY,1,HOUSING MANAGER (HA),54681,84588,Annual,29907
277704,NYC HOUSING AUTHORITY,1,INTERPRETER/TRANSLATOR,49900,55900,Annual,6000
277744,DEPT OF ENVIRONMENT PROTECTION,1,CLERICAL ASSOCIATE,33875,54879,Annual,21004
277750,NYC EMPLOYEES RETIREMENT SYS,1,CERTIFIED IT ADMINISTRATOR (LA,85823,121363,Annual,35540
278050,CULTURAL AFFAIRS,1,COMMUNITY ASSOCIATE,35683,50000,Annual,14317
277762,HOUSING PRESERVATION & DVLPMNT,1,COMMUNITY COORDINATOR,50362,60000,Annual,9638
277383,DEPT OF ENVIRONMENT PROTECTION,1,CONSTRUCTION PROJECT MANAGER,53134,79726,Annual,26592
278363,DEPT OF DESIGN & CONSTRUCTION,1,ASSOCIATE STAFF ANALYST,63817,95022,Annual,31205
277426,DEPT OF ENVIRONMENT PROTECTION,1,CITY RESEARCH SCIENTIST,59708,72246,Annual,12538
277460,DEPARTMENT OF INVESTIGATION,1,CONFIDENTIAL INVESTIGATOR,41996,60223,Annual,18227
277766,DEPT OF CITYWIDE ADMIN SVCS,1,ESTIMATOR (GENERAL CONSTRUCTIO,53134,79726,Annual,26592
277768,FIRE DEPARTMENT,1,ADMIN COMMUNITY RELATIONS SPEC,53051,81068,Annual,28017
277776,DEPT OF ENVIRONMENT PROTECTION,1,ADMINISTRATIVE ENGINEER,67060,178873,Annual,111813
277789,DEPT OF ENVIRONMENT PROTECTION,1,ADMINISTRATIVE PROJECT MANAGER,67060,178873,Annual,111813
277792,OFF OF PAYROLL ADMINISTRATION,1,COMPUTER SYSTEMS MANAGER,54643,120000,Annual,65357
277486,DEPT OF ENVIRONMENT PROTECTION,1,CITY RESEARCH SCIENTIST,59708,72246,Annual,12538
277818,ADMIN TRIALS AND HEARINGS,1,COMMUNITY ASSISTANT,30273,39275,Annual,9002
277488,DEPT OF INFO TECH & TELECOMM,1,COMMUNITY COORDINATOR,50362,70000,Annual,19638
277526,ADMIN TRIALS AND HEARINGS,1,COMPUTER SYSTEMS MANAGER,100000,100000,Annual,0
277826,ADMIN TRIALS AND HEARINGS,2,COMMUNITY ASSISTANT,30273,34814,Annual,4541
277531,DEPARTMENT OF INVESTIGATION,1,INSPECTOR GENERAL,115000,160000,Annual,45000
277533,DEPT OF ENVIRONMENT PROTECTION,2,CIVIL ENGINEER,74990,104182,Annual,29192
277833,HRA/DEPT OF SOCIAL SERVICES,1,SOCIAL WORKER,47549,54681,Annual,7132
277838,ADMIN TRIALS AND HEARINGS,1,COMMUNITY ASSOCIATE,35683,55000,Annual,19317
277845,DEPARTMENT OF INVESTIGATION,1,CONFIDENTIAL SECRETARY TO THE,54643,58926,Annual,4283
277557,DEPARTMENT OF INVESTIGATION,1,CONFIDENTIAL INVESTIGATOR,41996,60223,Annual,18227
277856,OFFICE OF THE COMPTROLLER,1,BUSINESS PROMOTION COORDINATOR,50000,65000,Annual,15000
277862,DEPARTMENT OF BUILDINGS,10,INSPECTOR (PLUMBING),49862,61800,Annual,11938
277579,OFF OF PAYROLL ADMINISTRATION,1,ACCOUNTANT,52143,72000,Annual,19857
277876,MAYORS OFFICE OF CONTRACT SVCS,1,EXECUTIVE AGENCY COUNSEL,80000,100000,Annual,20000
277883,HOUSING PRESERVATION & DVLPMNT,2,COMMUNITY COORDINATOR,55000,65000,Annual,10000
277907,DEPARTMENT OF SANITATION,1,EXECUTIVE ASSISTANT TO THE COM,54643,234738,Annual,180095
277979,NYC HOUSING AUTHORITY,1,SENIOR GENERAL DEPUTY MANAGER,190035,190035,Annual,0
277585,HUMAN RIGHTS COMMISSION,1,AGENCY ATTORNEY,58716,89638,Annual,30922
277599,DEPARTMENT OF TRANSPORTATION,1,CIVIL ENGINEER,83887,113725,Annual,29838
278006,DEPARTMENT OF TRANSPORTATION,1,ADMINISTRATIVE STAFF ANALYST (,120000,150000,Annual,30000
278020,DEPARTMENT OF TRANSPORTATION,1,PROCUREMENT ANALYST,54237,91169,Annual,36932
277650,HOUSING PRESERVATION & DVLPMNT,1,ADM CITY PLANNER (NON MGRL),75000,85000,Annual,10000
277651,DEPARTMENT OF INVESTIGATION,1,CONFIDENTIAL INVESTIGATOR,59791,75156,Annual,15365
277662,DEPARTMENT OF INVESTIGATION,1,CONFIDENTIAL INVESTIGATOR,50227,55000,Annual,4773
278031,ADMIN TRIALS AND HEARINGS,1,COMMUNITY SERVICE AIDE,27446,31431,Annual,3985
278141,BOARD OF CORRECTION,1,CITY RESEARCH SCIENTIST,78630,103332,Annual,24702
278144,DEPARTMENT OF BUILDINGS,4,INSPECTOR (HOISTS AND RIGGING),49862,72100,Annual,22238
278560,HOUSING PRESERVATION & DVLPMNT,1,COMMUNITY COORDINATOR,60000,65000,Annual,5000
278566,OFFICE OF THE COMPTROLLER,1,MANAGEMENT AUDITOR,75000,80000,Annual,5000
278260,DEPT OF ENVIRONMENT PROTECTION,1,ASSOCIATE PROJECT MANAGER,83887,113725,Annual,29838
278594,DEPT OF ENVIRONMENT PROTECTION,1,COMPUTER SYSTEMS MANAGER,67060,178873,Annual,111813
278342,DEPARTMENT OF INVESTIGATION,1,SPECIAL INVESTIGATOR,77250,92290,Annual,15040
278173,DEPT OF ENVIRONMENT PROTECTION,2,PRINCIPAL ADMINISTRATIVE ASSOC,53047,81068,Annual,28021
278179,HOUSING PRESERVATION & DVLPMNT,1,COMPUTER ASSOC (OPERATIONS),77500,87500,Annual,10000
278382,NYC DEPT OF VETERANS' SERVICES,1,COMMUNITY COORDINATOR,50362,60000,Annual,9638
278207,HRA/DEPT OF SOCIAL SERVICES,1,ADMINISTRATIVE STAFF ANALYST (,58675,93845,Annual,35170
278389,POLICE DEPARTMENT,1,EXECUTIVE AGENCY COUNSEL,54643,150371,Annual,95728
278397,DEPT OF ENVIRONMENT PROTECTION,2,COMPUTER ASSOC (OPERATIONS),47692,69493,Annual,21801
278262,DEPARTMENT OF INVESTIGATION,1,CONFIDENTIAL INVESTIGATOR,41996,60223,Annual,18227
278427,DEPARTMENT OF INVESTIGATION,1,CONFIDENTIAL INVESTIGATOR,50227,68085,Annual,17858
278493,OFFICE OF THE ACTUARY,1,ADMINISTRATIVE ACTUARY,140000,178873,Annual,38873
278277,DEPT OF CITYWIDE ADMIN SVCS,1,INVESTIGATOR,38617,61659,Annual,23042
278063,NYC EMPLOYEES RETIREMENT SYS,1,COMPUTER SPECIALIST (SOFTWARE),76288,95077,Annual,18789
278071,CULTURAL AFFAIRS,1,ADMINISTRATIVE LABOR RELATIONS,54643,120000,Annual,65357
278536,CIVILIAN COMPLAINT REVIEW BD,1,DEPUTY EXECUTIVE DIRECTOR (CIV,120000,160000,Annual,40000
278130,DEPT OF ENVIRONMENT PROTECTION,5,COMMUNITY COORDINATOR,60000,70000,Annual,10000
278137,MANHATTAN COMMUNITY BOARD #10,1,COMMUNITY ASSISTANT,30273,39275,Annual,9002
278876,NYC EMPLOYEES RETIREMENT SYS,1,CONFIDENTIAL STRATEGY PLANNER,55752,93845,Annual,38093
278717,DEPT OF INFO TECH & TELECOMM,1,COMMUNITY COORDINATOR,50362,70000,Annual,19638
278881,DEPT OF INFO TECH & TELECOMM,1,COMPUTER SYSTEMS MANAGER,75338,180000,Annual,104662
279057,DEPT OF CITYWIDE ADMIN SVCS,1,ADMINISTRATIVE PROCUREMENT ANA,58955,80000,Annual,21045
278817,LAW DEPARTMENT,1,ASSISTANT CORPORATION COUNSEL,66499,111104,Annual,44605
278632,DEPT OF ENVIRONMENT PROTECTION,2,PROJECT MANAGER INTERN#,47974,55170,Annual,7196
278633,DEPT OF ENVIRONMENT PROTECTION,1,ELECTRICAL ENGINEER,83887,113725,Annual,29838
278903,HOUSING PRESERVATION & DVLPMNT,1,COMPUTER SYSTEMS MANAGER,105000,115000,Annual,10000
278719,DEPT OF INFO TECH & TELECOMM,1,ADMINISTRATIVE CONSTRUCTION PR,60435,100000,Annual,39565
278728,DEPT OF INFO TECH & TELECOMM,1,CERT IT DEVELOPER (APP),85823,120000,Annual,34177
278729,DEPT OF INFO TECH & TELECOMM,1,ADMINISTRATIVE BUSINESS PROMOT,54643,100000,Annual,45357
278914,DEPT. OF HOMELESS SERVICES,1,COMMUNITY COORDINATOR,50362,78177,Annual,27815
278756,DEPT OF HEALTH/MENTAL HYGIENE,1,CRIMINALIST,61377,61377,Annual,0
278998,DEPARTMENT OF FINANCE,1,COMPUTER SYSTEMS MANAGER,67060,140000,Annual,72940
278928,HRA/DEPT OF SOCIAL SERVICES,1,PRINCIPAL ADMINISTRATIVE ASSOC,61400,61400,Annual,0
278778,DEPT OF ENVIRONMENT PROTECTION,1,CITY RESEARCH SCIENTIST,59708,72246,Annual,12538
278787,CONSUMER AFFAIRS,1,CITY RESEARCH SCIENTIST,70286,88213,Annual,17927
278939,CONFLICTS OF INTEREST BOARD,1,AGENCY ATTORNEY,58716,85000,Annual,26284
278943,DEPARTMENT OF BUSINESS SERV.,1,ASSISTANT COMMISSIONER (DBS),75338,194395,Annual,119057
278944,DEPARTMENT OF INVESTIGATION,1,ASSISTANT COMMISSIONER (DEPT O,67060,140000,Annual,72940
278956,ADMIN TRIALS AND HEARINGS,1,COMMUNITY ASSOCIATE,35683,49500,Annual,13817
278813,HOUSING PRESERVATION & DVLPMNT,2,COMMUNITY COORDINATOR,50362,70000,Annual,19638
279026,DEPT OF DESIGN & CONSTRUCTION,1,ADMINISTRATIVE PROJECT MANAGER,48535,134433,Annual,85898
279675,DEPARTMENT OF BUSINESS SERV.,1,BUSINESS PROMOTION COORDINATOR,39399,60000,Annual,20601
278857,CIVILIAN COMPLAINT REVIEW BD,1,EXECUTIVE AGENCY COUNSEL,60435,161497,Annual,101062
279131,DEPT OF PARKS & RECREATION,1,BOROUGH DIRECTOR OF RECREATION,125000,135000,Annual,10000
279134,DEPARTMENT OF INVESTIGATION,1,COMMUNITY ASSOCIATE,35683,40000,Annual,4317
279155,NYC EMPLOYEES RETIREMENT SYS,1,COMPUTER SPECIALIST (SOFTWARE),76288,95077,Annual,18789
279414,DEPT OF INFO TECH & TELECOMM,1,ADMINISTRATIVE PUBLIC INFORMAT,60435,140000,Annual,79565
279656,DEPT OF CITYWIDE ADMIN SVCS,2,CITY PLANNER,68229,90000,Annual,21771
279433,OFFICE OF THE COMPTROLLER,1,INVESTMENT ANALYST,55000,65000,Annual,10000
279672,OFFICE OF EMERGENCY MANAGEMENT,1,EMERGENCY PREPAREDNESS SPECIAL,60000,70000,Annual,10000
279435,CONSUMER AFFAIRS,1,COMMUNITY ASSOCIATE,35683,44342,Annual,8659
279442,LAW DEPARTMENT,3,ASSISTANT CORPORATION COUNSEL,66494,103883,Annual,37389
279462,DEPT OF ENVIRONMENT PROTECTION,1,AGENCY ATTORNEY,66326,99394,Annual,33068
279159,HUMAN RIGHTS COMMISSION,1,AGENCY ATTORNEY,66326,99394,Annual,33068
279188,DEPT. OF HOMELESS SERVICES,1,ADMINISTRATIVE DIRECTOR OF SOC,165087,185000,Annual,19913
279192,DEPT OF INFO TECH & TELECOMM,1,IT PROJECT SPECIALIST,75000,100000,Annual,25000
279466,DEPT OF INFO TECH & TELECOMM,1,ADMINISTRATIVE BUSINESS PROMOT,67060,170000,Annual,102940
279202,DEPARTMENT OF SANITATION,1,COMMUNITY COORDINATOR,50362,78177,Annual,27815
279211,CONSUMER AFFAIRS,1,ADMIN CONTRACT SPECIALIST (PYR,75338,90000,Annual,14662
279469,FINANCIAL INFO SVCS AGENCY,1,COMPUTER ASSOC (OPERATIONS),57223,80000,Annual,22777
279471,DEPT OF INFO TECH & TELECOMM,1,COMPUTER SYSTEMS MANAGER,75338,170000,Annual,94662
279230,DEPT OF ENVIRONMENT PROTECTION,1,COMMUNITY COORDINATOR,50362,60000,Annual,9638
279472,DEPARTMENT OF SANITATION,1,COMMUNITY COORDINATOR,50362,78177,Annual,27815
279254,DEPT OF INFO TECH & TELECOMM,1,IT PROJECT SPECIALIST,75000,100000,Annual,25000
279276,DEPARTMENT OF INVESTIGATION,1,SPECIAL INVESTIGATOR,40000,80000,Annual,40000
279508,NYC HOUSING AUTHORITY,4,LABOR RELATIONS ANALYST TRAINE,42393,55697,Annual,13304
279509,DEPT OF ENVIRONMENT PROTECTION,1,CITY PLANNING TECHNICIAN,36239,55596,Annual,19357
279515,HOUSING PRESERVATION & DVLPMNT,1,COMMUNITY COORDINATOR,55000,60000,Annual,5000
279280,LAW DEPARTMENT,4,ASSISTANT CORPORATION COUNSEL,68494,114437,Annual,45943
279537,DEPARTMENT OF INVESTIGATION,1,CONFIDENTIAL INVESTIGATOR,50227,59339,Annual,9112
279380,DEPT OF INFO TECH & TELECOMM,2,IT SECURITY SPECIALIST,75000,105000,Annual,30000
279384,ADMIN TRIALS AND HEARINGS,1,COMMUNITY ASSOCIATE,35683,55000,Annual,19317
279398,DEPT OF INFO TECH & TELECOMM,2,IT SECURITY SPECIALIST,75000,105000,Annual,30000
279405,DEPT OF INFO TECH & TELECOMM,1,COMPUTER SYSTEMS MANAGER,54643,110000,Annual,55357
279573,HOUSING PRESERVATION & DVLPMNT,2,CITY PLANNER,51393,68000,Annual,16607
279576,HOUSING PRESERVATION & DVLPMNT,1,COMPUTER SPECIALIST (OPERATION,100000,110000,Annual,10000
279597,DEPT OF DESIGN & CONSTRUCTION,1,COMMUNITY COORDINATOR,50362,78177,Annual,27815
279119,CONSUMER AFFAIRS,1,CITY RESEARCH SCIENTIST,87768,110000,Annual,22232
279619,DEPT OF INFO TECH & TELECOMM,1,COMPUTER ASSOC (OPERATIONS),47692,54846,Annual,7154
279642,DEPT OF INFO TECH & TELECOMM,1,COMPUTER ASSOC (SOFTWARE),71291,100000,Annual,28709
279067,DEPARTMENT FOR THE AGING,1,COMMUNITY COORDINATOR,50362,78177,Annual,27815
279677,OFFICE OF EMERGENCY MANAGEMENT,1,EMERGENCY PREPAREDNESS SPECIAL,60000,70000,Annual,10000
279839,DEPARTMENT OF TRANSPORTATION,2,COMMUNITY COORDINATOR,50362,78177,Annual,27815
279841,DEPT OF HEALTH/MENTAL HYGIENE,1,CRIMINALIST ASSISTANT DIRECTOR,54643,65000,Annual,10357
279845,CIVILIAN COMPLAINT REVIEW BD,1,DEPUTY ASSISTANT DIRECTOR (CIV,110000,130000,Annual,20000
280134,HRA/DEPT OF SOCIAL SERVICES,1,PROCUREMENT ANALYST,37411,45000,Annual,7589
280152,DEPT OF INFO TECH & TELECOMM,1,CERT IT DEVELOPER (APP),79471,110000,Annual,30529
280159,DEPT OF INFO TECH & TELECOMM,1,CERT IT DEVELOPER (APP),79471,105000,Annual,25529
279849,DEPARTMENT OF FINANCE,1,PROCUREMENT ANALYST,54237,75000,Annual,20763
279910,DISTRICT ATTORNEY KINGS COUNTY,1,COMMUNITY ASSOCIATE,35683,41036,Annual,5353
279682,DEPT OF INFO TECH & TELECOMM,1,COMPUTER SYSTEMS MANAGER,67060,120000,Annual,52940
279684,OFFICE OF EMERGENCY MANAGEMENT,1,EMERGENCY PREPAREDNESS MANAGER,90000,90000,Annual,0
279685,HOUSING PRESERVATION & DVLPMNT,1,COMMUNITY COORDINATOR,50362,57916,Annual,7554
279965,DEPARTMENT OF FINANCE,1,ACCOUNTANT,46747,60000,Annual,13253
279688,DEPT OF INFO TECH & TELECOMM,1,TELECOMMUNICATIONS ASSOCIATE (,56365,74000,Annual,17635
279981,DEPARTMENT OF FINANCE,1,COMPUTER SPECIALIST (SOFTWARE),85823,100000,Annual,14177
279976,CONSUMER AFFAIRS,1,COMMUNITY ASSOCIATE,35683,50000,Annual,14317
279692,DEPARTMENT OF BUILDINGS,1,AGENCY ATTORNEY,58716,72100,Annual,13384
279696,DISTRICT ATTORNEY RICHMOND COU,1,COMMUNITY COORDINATOR,55000,75000,Annual,20000
279697,DISTRICT ATTORNEY RICHMOND COU,2,COMPUTER PROGRAMMER ANALYST,47692,65000,Annual,17308
279992,DEPARTMENT OF TRANSPORTATION,2,COMMUNITY COORDINATOR,50362,78177,Annual,27815
279702,DEPT OF ENVIRONMENT PROTECTION,1,COMMUNITY COORDINATOR,50362,78177,Annual,27815
279709,DEPT OF ENVIRONMENT PROTECTION,2,ELECTRICAL ENGINEER,63074,91347,Annual,28273
279712,DEPARTMENT OF CITY PLANNING,1,CITY PLANNER,68229,85000,Annual,16771
279715,DEPT OF HEALTH/MENTAL HYGIENE,1,CRIMINALIST,61377,61377,Annual,0
279717,CONSUMER AFFAIRS,1,BUSINESS PROMOTION COORDINATOR,39399,45309,Annual,5910
279767,DEPT OF DESIGN & CONSTRUCTION,5,COMMUNITY COORDINATOR,50362,78177,Annual,27815
279999,DEPARTMENT OF FINANCE,1,ASSOCIATE STAFF ANALYST,63817,73389,Annual,9572
279768,DEPT OF INFO TECH & TELECOMM,1,COMPUTER SYSTEMS MANAGER,54643,120000,Annual,65357
280007,DEPARTMENT OF INVESTIGATION,1,COMPUTER SYSTEMS MANAGER,88000,110000,Annual,22000
279776,DEPT OF CITYWIDE ADMIN SVCS,1,ASSISTANT ARCHITECT,53134,70000,Annual,16866
280008,DEPARTMENT OF INVESTIGATION,1,COMPUTER SYSTEMS MANAGER,88000,110000,Annual,22000
279789,HOUSING PRESERVATION & DVLPMNT,1,CITY PLANNER,70000,75000,Annual,5000
279793,DEPARTMENT OF FINANCE,1,COMPUTER SPECIALIST (SOFTWARE),79471,90000,Annual,10529
279804,DEPARTMENT OF TRANSPORTATION,1,ADMINISTRATIVE ENGINEER,60435,161497,Annual,101062
280074,NYC EMPLOYEES RETIREMENT SYS,1,ADM MANAGER-NON-MGRL FRM M1/M2,49748,145991,Annual,96243
280085,HOUSING PRESERVATION & DVLPMNT,1,ADMINISTRATIVE PROJECT DIRECTO,125000,145000,Annual,20000
279813,HOUSING PRESERVATION & DVLPMNT,2,COMMUNITY COORDINATOR,50362,57916,Annual,7554
279821,DEPARTMENT OF FINANCE,1,COMPUTER SPECIALIST (SOFTWARE),92065,120000,Annual,27935
280104,DEPARTMENT OF TRANSPORTATION,1,ASSOCIATE STAFF ANALYST,63817,95022,Annual,31205
280105,DEPT OF INFO TECH & TELECOMM,1,COMMUNITY COORDINATOR,50362,60000,Annual,9638
280591,FIRE DEPARTMENT,1,ASSOCIATE RETIREMENT BENEFITS,56267,81410,Annual,25143
279830,DEPT OF CITYWIDE ADMIN SVCS,1,ARCHITECT,96470,113000,Annual,16530
279838,DEPT OF CITYWIDE ADMIN SVCS,1,ARCHITECT,90000,100000,Annual,10000
280343,DEPT OF INFO TECH & TELECOMM,1,CERT IT DEVELOPER (APP),79471,110000,Annual,30529
280186,DEPARTMENT OF INVESTIGATION,1,EXAMINING ATTORNEY,75000,87100,Annual,12100
280348,DEPARTMENT OF BUSINESS SERV.,5,BUSINESS PROMOTION COORDINATOR,39399,50000,Annual,10601
280193,DEPARTMENT OF CORRECTION,1,BAKER,33073,37373,Annual,4300
280349,FIRE DEPARTMENT,1,CITY RESEARCH SCIENTIST,70286,88213,Annual,17927
280486,DEPT OF INFO TECH & TELECOMM,1,AGENCY ATTORNEY INTERNE,57944,70000,Annual,12056
280488,DISTRICT ATTORNEY KINGS COUNTY,1,COMMUNITY ASSISTANT,30273,34814,Annual,4541
280350,DEPARTMENT OF BUSINESS SERV.,1,BUSINESS PROMOTION COORDINATOR,64551,75000,Annual,10449
280351,DEPARTMENT OF BUILDINGS,10,INSPECTOR (ELEVATORS),49862,61800,Annual,11938
280195,DEPT OF CITYWIDE ADMIN SVCS,1,ACCOUNTANT,46747,63519,Annual,16772
280356,DEPARTMENT OF BUILDINGS,1,COMPUTER SYSTEMS MANAGER,54643,100000,Annual,45357
280359,DEPT OF ENVIRONMENT PROTECTION,1,ADM CITY PLANNER (NON MGRL),49990,121000,Annual,71010
280409,HRA/DEPT OF SOCIAL SERVICES,1,PRINCIPAL ADMINISTRATIVE ASSOC,55144,55144,Annual,0
280202,DEPARTMENT OF TRANSPORTATION,1,PRINCIPAL ADMINISTRATIVE ASSOC,42856,62779,Annual,19923
280203,DEPARTMENT OF TRANSPORTATION,1,PRINCIPAL ADMINISTRATIVE ASSOC,42856,62779,Annual,19923
280417,NYC HOUSING AUTHORITY,1,RESIDENT BUILDING SUPERINTENDE,53056,82557,Annual,29501
280205,DEPARTMENT OF TRANSPORTATION,1,RESEARCH ASSISTANT,42288,63990,Annual,21702
280420,ADMIN TRIALS AND HEARINGS,1,AGENCY ATTORNEY,66326,80000,Annual,13674
280226,LAW DEPARTMENT,4,ASSISTANT CORPORATION COUNSEL,68494,94092,Annual,25598
280227,LAW DEPARTMENT,15,ASSISTANT CORPORATION COUNSEL,68494,88325,Annual,19831
280249,DEPT OF INFO TECH & TELECOMM,1,CERT IT DEVELOPER (APP),85823,115000,Annual,29177
280450,OFF OF PAYROLL ADMINISTRATION,1,ACCOUNTANT,46747,61669,Annual,14922
281139,FIRE DEPARTMENT,1,ASSOCIATE FIRE PROTECTION INSP,54960,76420,Annual,21460
280258,HRA/DEPT OF SOCIAL SERVICES,1,PRINCIPAL ADMINISTRATIVE ASSOC,53047,61004,Annual,7957
280284,FIRE DEPARTMENT,1,IT PROJECT SPECIALIST,75000,125000,Annual,50000
280451,DEPT OF HEALTH/MENTAL HYGIENE,1,MEDICOLEGAL INVESTIGATOR (OCME,78464,91197,Annual,12733
280454,DEPT OF INFO TECH & TELECOMM,1,CERT IT DEVELOPER (APP),85823,115000,Annual,29177
280316,FIRE DEPARTMENT,4,ASSOCIATE INSPECTOR (ELECTRICA,51185,72309,Annual,21124
280341,DEPT OF INFO TECH & TELECOMM,1,CERT IT DEVELOPER (APP),79471,105000,Annual,25529
280455,DEPT OF ENVIRONMENT PROTECTION,1,ASSOCIATE STAFF ANALYST,63817,87500,Annual,23683
280476,DEPT OF DESIGN & CONSTRUCTION,1,ADMIN COMMUNITY RELATIONS SPEC,53051,140066,Annual,87015
280169,DEPARTMENT OF FINANCE,2,COMMUNITY COORDINATOR,50362,78177,Annual,27815
280180,DEPT OF ENVIRONMENT PROTECTION,4,WATERSHED MAINTAINER,38197,55870,Annual,17673
280181,DEPT OF INFO TECH & TELECOMM,1,ADMINISTRATIVE BUSINESS PROMOT,54643,110000,Annual,55357
280589,DEPARTMENT OF TRANSPORTATION,2,CIVIL ENGINEER,83887,113725,Annual,29838
280592,DEPT OF PARKS & RECREATION,1,ADM MANAGER-NON-MGRL FRM M1/M2,80000,90000,Annual,10000
280731,DEPARTMENT OF TRANSPORTATION,1,APPRENTICE INSPECTOR (HIGHWAYS,29842,46898,Annual,17056
280733,DEPT OF ENVIRONMENT PROTECTION,1,COMMUNITY COORDINATOR,50362,70000,Annual,19638
280737,DEPT OF DESIGN & CONSTRUCTION,1,ADMINISTRATIVE STAFF ANALYST (,58675,156793,Annual,98118
280595,DEPARTMENT OF CORRECTION,2,ASSOCIATE CORRECTIONAL COUNSEL,55977,64374,Annual,8397
280598,DEPARTMENT OF TRANSPORTATION,1,CONFIDENTIAL STRATEGY PLANNER,55752,93845,Annual,38093
280604,DEPARTMENT OF TRANSPORTATION,1,COMMUNITY COORDINATOR,50362,78177,Annual,27815
280739,DEPARTMENT OF CORRECTION,1,COMMUNITY ASSOCIATE,35683,41036,Annual,5353
280607,OFFICE OF LABOR RELATIONS,1,COMMUNITY COORDINATOR,50362,78177,Annual,27815
280608,DEPARTMENT OF TRANSPORTATION,1,COMMUNITY COORDINATOR,50362,78177,Annual,27815
280609,HRA/DEPT OF SOCIAL SERVICES,1,PRINCIPAL ADMINISTRATIVE ASSOC,61004,81068,Annual,20064
280497,DEPT OF ENVIRONMENT PROTECTION,1,ASSOCIATE CHEMIST,66302,93758,Annual,27456
280625,DEPT OF PARKS & RECREATION,1,COMMUNITY COORDINATOR,50362,55000,Annual,4638
280629,DEPT OF PARKS & RECREATION,1,PARK SUPERVISOR,76801,76801,Annual,0
280520,HOUSING PRESERVATION & DVLPMNT,2,ASSOCIATE STAFF ANALYST,65000,65000,Annual,0
280523,DEPARTMENT OF CORRECTION,1,COMMUNITY COORDINATOR,50362,57916,Annual,7554
280634,OFF OF PAYROLL ADMINISTRATION,1,TELECOMMUNICATION MANAGER,54643,70000,Annual,15357
280635,OFFICE OF LABOR RELATIONS,1,COMMUNITY ASSOCIATE,35683,59385,Annual,23702
280525,HOUSING PRESERVATION & DVLPMNT,1,ADM CITY PLANNER (NON MGRL),60000,70000,Annual,10000
280637,DEPT OF INFO TECH & TELECOMM,1,COMMUNITY COORDINATOR,50362,75000,Annual,24638
280638,DEPT OF PARKS & RECREATION,1,CITY RESEARCH SCIENTIST,75000,85000,Annual,10000
280641,DEPT. OF HOMELESS SERVICES,1,COMMUNITY COORDINATOR,50362,78177,Annual,27815
280548,DEPARTMENT FOR THE AGING,1,COMMUNITY COORDINATOR,50362,78177,Annual,27815
280549,DEPARTMENT OF CORRECTION,1,COMMUNITY COORDINATOR,57916,78177,Annual,20261
280551,DEPARTMENT FOR THE AGING,1,COMMUNITY COORDINATOR,60000,65000,Annual,5000
280643,DEPARTMENT OF CORRECTION,5,COMMISSARY MANAGER,30754,34752,Annual,3998
280552,DEPARTMENT OF CORRECTION,2,COMMUNITY COORDINATOR,57916,65000,Annual,7084
280553,DEPT OF DESIGN & CONSTRUCTION,1,COMPUTER SYSTEMS MANAGER,54643,150371,Annual,95728
280555,DEPARTMENT OF CORRECTION,2,AGENCY ATTORNEY INTERNE,57944,66636,Annual,8692
280657,ADMIN FOR CHILDREN'S SVCS,4,DIRECTOR OF FIELD OPERATIONS (,54643,150371,Annual,95728
280663,HOUSING PRESERVATION & DVLPMNT,1,ADMINISTRATIVE INSPECTOR (HOUS,74165,84165,Annual,10000
280578,HOUSING PRESERVATION & DVLPMNT,1,CONSTRUCTION PROJECT MANAGER,63074,75000,Annual,11926
280566,DEPARTMENT OF TRANSPORTATION,1,ELECTRICAL ENGINEER,83887,113725,Annual,29838
280666,DEPT OF PARKS & RECREATION,1,ADMINISTRATIVE STAFF ANALYST (,80000,90000,Annual,10000
280667,DEPT OF PARKS & RECREATION,1,ADMIN COMMUNITY RELATIONS SPEC,80000,90000,Annual,10000
280709,DEPT OF ENVIRONMENT PROTECTION,1,CITY RESEARCH SCIENTIST,78630,103332,Annual,24702
280713,DEPT OF ENVIRONMENT PROTECTION,1,COMPUTER ASSOC (SOFTWARE),61995,85943,Annual,23948
280569,DEPARTMENT OF INVESTIGATION,1,COMMUNITY COORDINATOR,50362,60000,Annual,9638
280714,DEPT OF DESIGN & CONSTRUCTION,1,ADM MANAGER-NON-MGRL FRM M1/M2,49748,145991,Annual,96243
280570,HOUSING PRESERVATION & DVLPMNT,1,SUPERVISOR OF MECHANICAL INSTA,53134,61800,Annual,8666
280574,DEPARTMENT OF TRANSPORTATION,1,MECHANICAL ENGINEER,83887,113725,Annual,29838
280720,FIRE DEPARTMENT,1,ADMINISTRATIVE PROJECT MANAGER,48535,134433,Annual,85898
280724,DEPT OF DESIGN & CONSTRUCTION,1,ASSOCIATE STAFF ANALYST,63817,95022,Annual,31205
280580,DEPT OF PARKS & RECREATION,7,CITY PARK WORKER,32317,37164,Annual,4847
280587,DEPT OF PARKS & RECREATION,1,COMMUNITY COORDINATOR,60000,70000,Annual,10000
280774,LAW DEPARTMENT,1,ASSISTANT CORPORATION COUNSEL,88325,114437,Annual,26112
280966,HRA/DEPT OF SOCIAL SERVICES,1,COMPUTER SPECIALIST (SOFTWARE),79471,91392,Annual,11921
280922,DEPARTMENT OF TRANSPORTATION,1,STAFF ANALYST,56458,72310,Annual,15852
280935,HOUSING PRESERVATION & DVLPMNT,1,ACCOUNTANT,46747,61000,Annual,14253
281130,DEPT OF INFO TECH & TELECOMM,1,COMPUTER SYSTEMS MANAGER,60435,130000,Annual,69565
280952,DEPARTMENT OF CORRECTION,2,CORRECTIONAL STANDARDS REVIEW,57065,65625,Annual,8560
281138,HOUSING PRESERVATION & DVLPMNT,1,COMMUNITY COORDINATOR,60000,70000,Annual,10000
281140,DEPARTMENT OF TRANSPORTATION,1,CLERICAL ASSOCIATE,37251,58478,Annual,21227
280954,DEPARTMENT OF CORRECTION,1,CORRECTIONAL STANDARDS REVIEW,57065,65625,Annual,8560
280788,HOUSING PRESERVATION & DVLPMNT,1,ADM HOUSING DEV SPEC(NON MGRL),80000,85000,Annual,5000
280792,DEPT OF INFO TECH & TELECOMM,2,RADIO AND TELEVISION OPERATOR,39906,50000,Annual,10094
281012,DEPARTMENT OF TRANSPORTATION,1,INDUSTRIAL HYGIENIST,52168,70113,Annual,17945
280802,NYC EMPLOYEES RETIREMENT SYS,1,CERTIFIED IT ADMINISTRATOR (LA,92065,138961,Annual,46896
281025,FIRE DEPARTMENT,1,COMPUTER SPECIALIST (SOFTWARE),79471,102388,Annual,22917
280822,DEPARTMENT OF CORRECTION,2,SENIOR COOK,35956,40630,Annual,4674
281028,DEPARTMENT OF FINANCE,10,CITY TAX AUDITOR,52143,59964,Annual,7821
281044,FIRE DEPARTMENT,1,PRINCIPAL ADMINISTRATIVE ASSOC,47951,69703,Annual,21752
281049,HOUSING PRESERVATION & DVLPMNT,1,COMPUTER SPECIALIST (OPERATION,85000,95000,Annual,10000
280875,DEPARTMENT OF CITY PLANNING,1,COMMUNITY COORDINATOR,65000,75000,Annual,10000
281063,DEPARTMENT OF CORRECTION,1,COMMUNITY ASSOCIATE,35683,41036,Annual,5353
281051,DEPT OF DESIGN & CONSTRUCTION,2,INVESTIGATOR (EMPLOYEE DISCIPL,39381,60223,Annual,20842
281129,NYC HOUSING AUTHORITY,1,ASSISTANT EXECUTIVE DIRECTOR (,162500,165000,Annual,2500
280890,DEPARTMENT OF TRANSPORTATION,1,ADMINISTRATIVE STAFF ANALYST (,61031,95022,Annual,33991
280920,DEPARTMENT OF TRANSPORTATION,1,ASSISTANT HIGHWAY TRANSPORTATI,45919,67556,Annual,21637
281082,HOUSING PRESERVATION & DVLPMNT,1,COMPUTER ASSOC (OPERATIONS),77500,87500,Annual,10000
280921,DEPARTMENT OF TRANSPORTATION,1,CITY PLANNER,60702,89359,Annual,28657
281084,HUMAN RIGHTS COMMISSION,1,ASSOCIATE HUMAN RIGHTS SPECIAL,54410,62571,Annual,8161
281360,FIRE DEPARTMENT,1,ADMIN COMMUNITY RELATIONS SPEC,90000,90000,Annual,0
281114,CIVILIAN COMPLAINT REVIEW BD,1,COMMUNITY ASSOCIATE,35683,59385,Annual,23702
280747,DEPARTMENT OF CORRECTION,1,CORRECTIONAL STANDARDS REVIEW,57065,65625,Annual,8560
280751,LAW DEPARTMENT,1,ASSISTANT CORPORATION COUNSEL,68494,94096,Annual,25602
280768,DEPARTMENT OF TRANSPORTATION,1,ADMINISTRATIVE ACCOUNTANT,60435,135000,Annual,74565
281152,DEPARTMENT OF TRANSPORTATION,4,ASSISTANT HIGHWAY TRANSPORTATI,45919,67556,Annual,21637
281170,DEPARTMENT OF TRANSPORTATION,2,ASSISTANT ELECTRICAL ENGINEER,53134,79726,Annual,26592
281337,HRA/DEPT OF SOCIAL SERVICES,1,ASSOCIATE JOB OPPORTUNITY SPEC,56591,84929,Annual,28338
281357,HOUSING PRESERVATION & DVLPMNT,1,ADM CITY PLANNER (NON MGRL),65000,75000,Annual,10000
281359,HOUSING PRESERVATION & DVLPMNT,1,COMMUNITY COORDINATOR,60000,75000,Annual,15000
281365,DEPT OF PARKS & RECREATION,1,COMMUNITY ASSOCIATE,50000,57000,Annual,7000
281373,DEPT OF PARKS & RECREATION,3,SURVEYOR,53134,61104,Annual,7970
281376,BUSINESS INTEGRITY COMMISSION,3,COMMUNITY ASSOCIATE,35683,59385,Annual,23702
281171,DEPARTMENT OF TRANSPORTATION,1,ASSISTANT ELECTRICAL ENGINEER,53134,79726,Annual,26592
281304,HOUSING PRESERVATION & DVLPMNT,1,COMMUNITY COORDINATOR,64000,74000,Annual,10000
281377,DEPT OF PARKS & RECREATION,2,COMMUNITY ASSOCIATE,50000,55000,Annual,5000
281211,CIVILIAN COMPLAINT REVIEW BD,1,EXECUTIVE DIRECTOR (CIVILIAN C,108455,234738,Annual,126283
281397,DEPT OF ENVIRONMENT PROTECTION,2,SCIENTIST (WATER ECOLOGY),49274,72160,Annual,22886
281214,DEPARTMENT OF INVESTIGATION,1,DEPUTY INSPECTOR GENERAL,80000,100296,Annual,20296
281222,DEPARTMENT OF TRANSPORTATION,1,ADMINISTRATIVE STAFF ANALYST (,58675,156793,Annual,98118
281410,CONSUMER AFFAIRS,1,COMPUTER SYSTEMS MANAGER,54643,150371,Annual,95728
281439,FINANCIAL INFO SVCS AGENCY,1,COMPUTER ASSOC (SOFTWARE),71291,87450,Annual,16159
281457,DEPT OF HEALTH/MENTAL HYGIENE,1,CRIMINALIST,61377,61377,Annual,0
281472,DEPARTMENT OF TRANSPORTATION,1,PROCUREMENT ANALYST,46069,74444,Annual,28375
281242,DISTRICT ATTORNEY KINGS COUNTY,1,COMMUNITY ASSOCIATE,35683,59385,Annual,23702
281476,TAXI & LIMOUSINE COMMISSION,1,AGENCY ATTORNEY,73938,109153,Annual,35215
281478,TAXI & LIMOUSINE COMMISSION,1,AGENCY ATTORNEY,73938,109153,Annual,35215
281479,DEPARTMENT OF CORRECTION,1,CORRECTIONAL STANDARDS REVIEW,57065,65625,Annual,8560
281480,TAXI & LIMOUSINE COMMISSION,1,AGENCY ATTORNEY,73938,109153,Annual,35215
281493,HOUSING PRESERVATION & DVLPMNT,1,ADMINISTRATIVE HOUSING DEVELOP,105000,135000,Annual,30000
281495,LAW DEPARTMENT,1,LEGAL SECRETARIAL ASSISTANT AL,50000,53314,Annual,3314
281254,DISTRICT ATTORNEY KINGS COUNTY,1,COMMUNITY ASSOCIATE,35683,41036,Annual,5353
281560,LAW DEPARTMENT,1,CLAIM SPECIALIST,38617,61659,Annual,23042
281569,DEPT OF INFO TECH & TELECOMM,1,ASSOCIATE CALL CENTER REPRESEN,44197,50826,Annual,6629
281575,DEPT OF INFO TECH & TELECOMM,1,COMMUNITY COORDINATOR,50362,78000,Annual,27638
281265,FIRE DEPARTMENT,1,SPVSG FAD-DIR DSPTCH OP DETAIL,60435,161497,Annual,101062
281585,CONSUMER AFFAIRS,1,ADMINISTRATIVE BUSINESS PROMOT,67060,95000,Annual,27940
281288,DEPARTMENT OF CORRECTION,1,DIETARY AIDE,32221,37054,Annual,4833
281593,CONSUMER AFFAIRS,1,BUSINESS PROMOTION COORDINATOR,39399,45309,Annual,5910
281600,DEPT OF INFO TECH & TELECOMM,1,ADMINISTRATIVE PUBLIC INFORMAT,54643,100000,Annual,45357
